OBJECTID,GEO.id,acs_bpl,acs_bplp,acs_bplm,acs_bplf,acs_bplmp,acs_bplfp,acs_mi
1,1400000US11001007407,942,31.7,427,515,28.7,34.6,36453
2,1400000US11001007409,1261,34.2,442,819,29.4,37.5,26636
3,1400000US11001007502,1434,37.8,617,817,38.7,37.1,31179
4,1400000US11001007503,852,37.8,415,437,39.9,36.1,31551
5,1400000US11001007504,1384,47.6,470,914,34.8,58.7,20625
6,1400000US11001007603,552,12.5,185,367,9.7,14.6,49744
7,1400000US11001007604,717,21.2,343,374,23.8,19.3,43968
8,1400000US11001007605,970,28.5,420,550,26.4,30.2,42152
9,1400000US11001007707,603,16.1,169,434,10.9,19.7,38571
10,1400000US11001007708,922,32,384,538,28,35.6,35534
11,1400000US11001007709,252,16.1,118,134,15.1,17.1,25451
12,1400000US11001007803,728,25.9,317,411,23.4,28.1,22685
13,1400000US11001007804,990,35.8,262,728,23.8,43.8,25208
14,1400000US11001007807,566,27.9,203,363,26.3,28.9,27917
15,1400000US11001007808,1451,39.2,436,1015,26.8,48.8,27531
16,1400000US11001007809,950,35,412,538,34.8,35.2,22109
17,1400000US11001007903,238,16.1,50,188,8.2,21.8,43304
18,1400000US11001008001,291,11.7,12,279,1.2,19.2,89128
19,1400000US11001008002,267,7.5,136,131,7.3,7.7,92874
20,1400000US11001008200,361,13,155,206,12.5,13.4,83214
21,1400000US11001008301,172,7.3,126,46,9.9,4.3,115216
22,1400000US11001008402,478,19.7,28,450,2.9,31.2,54683
23,1400000US11001008410,227,14.5,106,121,10.9,20.6,96667
24,1400000US11001008701,160,8.3,24,136,2.8,12.5,64464
25,1400000US11001008802,1202,27.4,486,716,23.7,30.7,38859
26,1400000US11001008803,360,32.9,222,138,38.1,27,37833
27,1400000US11001008804,1109,40.3,630,479,43.6,36.7,25978
28,1400000US11001008903,665,29.4,327,338,28.4,30.5,26556
29,1400000US11001009000,434,16.9,145,289,14.4,18.6,39653
30,1400000US11001009102,1567,32.8,707,860,30.5,35.1,32806
31,1400000US11001009201,240,19.4,83,157,14.7,23.4,44939
32,1400000US11001009204,586,24.4,203,383,19.4,28.4,28814
33,1400000US11001000100,334,7,126,208,5.3,8.6,109947
35,1400000US11001000400,63,4.9,49,14,7.5,2.2,158580
36,1400000US11001000702,267,8.6,133,134,10,7.5,63794
37,1400000US11001001002,531,15.9,151,380,11.3,19,85543
38,1400000US11001001401,196,6.2,107,89,6.8,5.6,109609
39,1400000US11001001702,243,9.9,109,134,9.9,9.8,91989
40,1400000US11001002201,124,3.5,53,71,3.2,3.9,70541
41,1400000US11001002501,652,28.4,326,326,25.5,32,48750
42,1400000US11001002801,796,20.9,391,405,19.2,22.9,43661
43,1400000US11001002900,700,18,399,301,19.1,16.7,56000
44,1400000US11001003301,634,22.4,360,274,25.1,19.7,83285
45,1400000US11001003600,829,19.5,396,433,19.4,19.7,46034
46,1400000US11001004002,127,5.5,48,79,4.2,6.7,85368
47,1400000US11001004202,114,4.8,38,76,3.4,6.1,83588
48,1400000US11001004702,485,33.1,323,162,43.4,22.5,43476
49,1400000US11001004901,451,24.3,163,288,17.8,30.8,52375
50,1400000US11001005600,1245,26.2,445,800,19.9,31.9,61806
51,1400000US11001006400,598,31.1,184,414,21.7,38.5,21191
52,1400000US11001006801,327,17.9,177,150,21.7,14.9,77955
53,1400000US11001007100,1518,45.4,532,986,38.7,50.1,29493
54,1400000US11001007403,983,35.7,555,428,42.6,29.4,27333
55,1400000US11001007408,1220,53.3,496,724,58.4,50.2,17826
56,1400000US11001007601,759,19.4,328,431,18.4,20.1,37687
57,1400000US11001007703,1473,26.3,525,948,22.9,28.7,31955
58,1400000US11001007806,486,23,142,344,15.7,28.5,42171
59,1400000US11001007901,1420,37.7,422,998,26.7,45.6,32692
60,1400000US11001008302,57,2.8,21,36,2.2,3.4,101667
61,1400000US11001008702,287,16.8,131,156,15.2,18.3,41232
62,1400000US11001008904,846,25.8,426,420,27,24.7,27620
63,1400000US11001009203,314,12.4,237,77,16.5,7,51726
64,1400000US11001009302,53,4.4,53,0,8.5,0,63958
65,1400000US11001009504,359,13,176,183,12.3,13.8,50500
66,1400000US11001009509,151,5.5,33,118,2.7,7.8,59286
67,1400000US11001009602,1239,41.8,450,789,39.3,43.3,24786
68,1400000US11001009603,496,15.2,198,298,13.8,16.3,38404
69,1400000US11001009604,402,20.1,92,310,14.3,22.8,37441
70,1400000US11001009700,764,31.8,295,469,30.2,32.9,31549
71,1400000US11001009802,533,45.6,232,301,49.5,43,23633
72,1400000US11001009807,461,14.5,234,227,15.2,13.9,42420
73,1400000US11001009904,385,23.8,77,308,10,36.3,35302
74,1400000US11001009906,219,13.1,129,90,14.5,11.6,34269
75,1400000US11001010500,822,19.4,424,398,18.2,20.9,57052
76,1400000US11001010800,1011,64.7,425,586,60.6,68.1,11375
77,1400000US11001000202,495,14.4,197,298,11.5,17.4,120114
78,1400000US11001000300,681,12,323,358,11.3,12.7,101250
79,1400000US11001000501,459,14.3,92,367,7,19.3,87415
80,1400000US11001000502,234,7.2,88,146,6.2,8,95694
81,1400000US11001000600,216,5.3,53,163,2.8,7.6,115648
82,1400000US11001000701,69,1.5,0,69,0,2.6,79649
83,1400000US11001000802,209,8.1,118,91,9.3,6.9,92000
84,1400000US11001000901,183,4.9,101,82,5.5,4.3,213889
85,1400000US11001000902,128,5.7,21,107,1.9,9.3,163750
86,1400000US11001001001,543,7.7,318,225,9.6,6,142697
87,1400000US11001001100,314,7.4,124,190,6.1,8.5,141607
88,1400000US11001001200,485,9.7,159,326,7.3,11.6,93785
89,1400000US11001001301,427,10.1,308,119,14.2,5.8,88981
90,1400000US11001001302,451,6.4,154,297,5.1,7.5,78961
91,1400000US11001001402,198,6.8,48,150,3.4,9.9,100750
92,1400000US11001001500,169,3,88,81,3.2,2.8,179125
93,1400000US11001001600,172,3.9,33,139,1.6,5.9,133824
94,1400000US11001001803,424,14.3,177,247,12.9,15.5,35350
95,1400000US11001001804,1276,26.5,540,736,23.1,29.8,40281
96,1400000US11001001901,443,10.6,80,363,4.6,14.9,48073
97,1400000US11001002001,188,7,119,69,9.4,4.9,43478
98,1400000US11001002002,412,11.5,185,227,12.1,11,53373
99,1400000US11001002101,806,17,417,389,18.1,16,41886
100,1400000US11001002102,526,12.2,149,377,8.9,14.3,42522
101,1400000US11001002202,315,10.8,170,145,13.4,8.8,42283
102,1400000US11001002301,367,12.3,165,202,10.3,14.6,61500
103,1400000US11001002302,401,30.9,222,179,29.9,32.2,43342
104,1400000US11001002400,478,12.7,286,192,14.4,10.8,60082
105,1400000US11001002502,532,11,332,200,14.3,8,42199
106,1400000US11001002600,137,6,83,54,8,4.3,144141
107,1400000US11001002701,654,12.5,299,355,10.7,14.7,58617
108,1400000US11001002702,387,7.6,115,272,4.5,10.6,95490
109,1400000US11001002802,860,21.6,385,475,19.3,24,41453
110,1400000US11001003000,701,23.1,361,340,26.1,20.7,52228
111,1400000US11001003100,224,7.8,113,111,6.8,9.1,69063
112,1400000US11001003200,918,20.5,287,631,14.1,25.9,50665
113,1400000US11001003302,416,18.9,179,237,15.7,22.4,80039
114,1400000US11001003400,900,34,357,543,26.2,42.2,30603
115,1400000US11001003500,744,31.9,407,337,30.1,34.3,41136
116,1400000US11001003700,1111,26.2,624,487,31.2,21.7,52292
117,1400000US11001003800,240,5.9,194,46,8.1,2.8,76121
118,1400000US11001003900,230,5.1,153,77,7,3.4,72466
119,1400000US11001004001,120,3.7,74,46,4.5,2.9,100439
120,1400000US11001004100,114,4.2,46,68,3.6,4.8,97500
121,1400000US11001004201,694,19.6,394,300,19.3,20,86406
122,1400000US11001004300,552,19.3,295,257,21.1,17.6,51016
123,1400000US11001004400,550,12.3,316,234,13.7,10.7,98030
124,1400000US11001004600,454,19.1,150,304,14.2,22.9,76623
125,1400000US11001004701,1884,49,720,1164,45,51.9,15119
126,1400000US11001004801,252,14.4,101,151,12.1,16.5,76618
127,1400000US11001004802,418,13.7,161,257,11.5,15.5,42244
128,1400000US11001004902,453,17.3,229,224,15.8,19.1,78482
129,1400000US11001005001,163,10.3,163,0,15.1,0,119643
130,1400000US11001005002,689,11.8,462,227,13.9,9.1,73173
131,1400000US11001005201,619,11.9,329,290,10.7,13.6,64811
132,1400000US11001005301,1000,16.7,513,487,16.6,16.8,91638
133,1400000US11001005500,758,12.8,414,344,13.6,11.9,88831
134,1400000US11001005800,150,5.6,44,106,3.4,7.7,119167
135,1400000US11001005900,1570,44.4,1086,484,51.4,34,66790
136,1400000US11001006202,0,-,0,0,-,-,-
137,1400000US11001006500,33,1.3,11,22,1,1.5,113542
138,1400000US11001006600,162,8.7,54,108,6.5,10.5,94878
139,1400000US11001006700,184,4.6,128,56,6.6,2.7,141004
140,1400000US11001006802,56,2.7,27,29,2.9,2.5,86719
141,1400000US11001006804,31,91.2,24,7,88.9,100,-
142,1400000US11001006900,202,9.1,53,149,4.9,13,115299
143,1400000US11001007000,208,10.7,58,150,7.1,13.3,92656
144,1400000US11001007200,141,11.7,67,74,12.1,11.4,47885
145,1400000US11001007301,35,1.4,25,10,1.9,0.9,64821
146,1400000US11001007304,1298,38.2,450,848,30.3,44.3,31856
147,1400000US11001007401,1255,57.3,445,810,47.3,64.7,19238
148,1400000US11001007404,1616,48.8,667,949,47.4,49.8,26250
149,1400000US11001007406,1495,47.2,601,894,45.7,48.3,27838
150,1400000US11001009301,810,23.2,253,557,15.7,29.7,72578
151,1400000US11001009400,344,8.7,177,167,10,7.6,70990
152,1400000US11001009501,796,19.7,471,325,22.8,16.5,40536
153,1400000US11001009503,244,8.8,102,142,8,9.5,70875
154,1400000US11001009505,167,6.2,58,109,5.3,6.9,62462
155,1400000US11001009507,83,4.4,41,42,4.9,4,62986
156,1400000US11001009508,271,9,123,148,9.2,8.8,47410
157,1400000US11001009601,1336,45.6,538,798,56.3,40.5,40929
158,1400000US11001009801,606,39.6,250,356,33.7,45.2,31917
159,1400000US11001009803,567,24.3,206,361,21.6,26.2,30625
160,1400000US11001009804,702,24.5,320,382,26.1,23.4,46554
161,1400000US11001009810,813,34.9,343,470,33.2,36.3,26234
162,1400000US11001009811,1631,46.2,494,1137,39.9,49.6,21713
163,1400000US11001009901,121,6,25,96,2.8,8.5,76736
164,1400000US11001009902,650,23.4,275,375,24.6,22.6,51400
165,1400000US11001009903,337,24.3,148,189,21.6,27,52554
166,1400000US11001009905,483,18.1,209,274,17,19,35186
167,1400000US11001009907,1053,40.7,303,750,33.3,44.7,26612
168,1400000US11001010100,296,14,117,179,11.3,16.5,51151
169,1400000US11001010200,281,10.6,110,171,10.4,10.7,74744
170,1400000US11001010300,133,4.9,30,103,2.2,7.6,56736
171,1400000US11001010400,1354,34.3,785,569,37.2,31,33500
172,1400000US11001010600,589,16.2,341,248,16.7,15.5,65122
173,1400000US11001010700,494,28.6,179,315,26.2,30.2,55268
174,1400000US11001010900,1480,48.4,426,1054,35.1,57.3,28519
175,1400000US11001011000,708,17.4,294,414,17.1,17.7,79297
176,1400000US11001011100,444,11.1,197,247,10.6,11.6,55353
177,1400000US11001001902,165,7.8,83,82,8.7,7,72273
178,1400000US11001008100,222,6.6,49,173,3,10,132321
179,1400000US11001000801,403,7,204,199,8,6.1,114732
180,1400000US51059415100,233,6.8,91,142,5.6,7.9,109609
181,1400000US51059415401,314,6.8,189,125,9,4.9,61421
182,1400000US51059416000,775,14.9,260,515,10.8,18.3,71217
183,1400000US51059420100,599,14.7,383,216,18,11.1,84461
184,1400000US51059420800,330,9,187,143,9.5,8.5,88456
185,1400000US51059421200,0,0,0,0,0,0,119531
186,1400000US51059421600,853,14.6,274,579,9.8,19.1,52652
187,1400000US51059421800,495,9.3,255,240,10.4,8.4,74565
188,1400000US51059422301,26,0.9,0,26,0,1.9,93646
189,1400000US51059422401,178,9.1,13,165,1.5,15.6,85924
190,1400000US51059430203,246,8.9,66,180,5,12.4,119000
191,1400000US51059430500,64,3.8,32,32,4.2,3.5,90000
192,1400000US51059430901,164,3.7,74,90,3.7,3.8,89740
193,1400000US51059431801,102,2.5,0,102,0,4.8,95469
194,1400000US51059431900,0,0,0,0,0,0,154811
195,1400000US51059432300,185,3.5,89,96,3.4,3.6,146250
196,1400000US51059432702,115,2.7,63,52,2.8,2.7,92692
197,1400000US51059440600,124,4,75,49,5.1,3,96513
198,1400000US51059450200,551,14.1,291,260,14.9,13.3,79496
199,1400000US51059450500,333,12.3,169,164,12.3,12.3,92766
200,1400000US51059450702,606,15.3,269,337,12.8,18.1,59821
201,1400000US51059451300,0,0,0,0,0,0,124107
202,1400000US51059451900,288,4.9,80,208,3,6.6,88114
203,1400000US51059452102,366,13.6,137,229,10.8,16.1,62379
204,1400000US51059452502,1208,24.9,624,584,25.5,24.3,50647
205,1400000US51059452802,441,15.3,170,271,13,17.2,72580
206,1400000US51059460200,87,2.2,26,61,1.4,2.9,189500
207,1400000US51059460300,39,1.4,9,30,0.6,2.2,166000
208,1400000US51059460600,24,0.6,0,24,0,1.3,132695
209,1400000US51059461000,43,2,7,36,0.7,3.1,139712
210,1400000US51059461601,144,2.4,107,37,3.5,1.3,106480
211,1400000US51059461901,428,11.5,189,239,10.3,12.6,68404
212,1400000US51059470600,163,5.7,15,148,1.1,9.8,155250
213,1400000US51059471000,31,1.6,31,0,3.4,0,137000
214,1400000US51059471303,139,3.8,38,101,2.3,5.1,92434
215,1400000US51059480202,17,0.8,3,14,0.3,1.3,77500
216,1400000US51059480501,0,0,0,0,0,0,185057
217,1400000US51059480802,110,2.7,41,69,1.9,3.6,105101
218,1400000US51059481000,72,1.8,12,60,0.6,3.3,67262
219,1400000US51059481104,37,1.4,6,31,0.5,2.5,102923
220,1400000US51059481701,32,0.5,10,22,0.3,0.7,193468
221,1400000US51059482301,61,1.5,29,32,1.4,1.6,97460
222,1400000US51059482502,0,0,0,0,0,0,144550
223,1400000US51059490501,116,3.7,103,13,6,0.9,75684
224,1400000US51059491202,285,19.8,134,151,15.6,26,62716
225,1400000US51059491401,439,9.8,164,275,8,11.2,84000
226,1400000US51059491501,349,5.5,127,222,4.4,6.4,94286
227,1400000US51059491703,291,6.8,138,153,6,7.7,86981
228,1400000US51059491801,169,6.9,113,56,8,5.4,88155
229,1400000US51059492202,106,1.6,75,31,2.3,0.9,176915
230,1400000US51059980100,0,-,0,0,-,-,-
231,1400000US51013100100,39,0.9,21,18,0.9,0.9,161528
232,1400000US51013100400,8,0.2,0,8,0,0.5,211818
233,1400000US51013100800,62,4.3,40,22,5.3,3.2,56094
234,1400000US51013101401,66,5.3,18,48,2.9,7.6,88448
235,1400000US51013101602,76,5.4,11,65,1.8,8.2,94297
236,1400000US51013101703,323,13.1,116,207,8.6,18.6,77933
237,1400000US51013101900,10,0.4,2,8,0.2,0.5,144792
238,1400000US51013102301,24,1.8,15,9,2.4,1.3,98571
239,1400000US51013102702,247,17.5,136,111,16.6,18.6,86920
240,1400000US51013102902,256,6.3,130,126,6.9,5.8,91940
241,1400000US51013103402,196,5.1,104,92,5.8,4.5,108203
242,1400000US51013103602,119,10.9,28,91,6.8,13.4,80268
243,1400000US51510200103,801,10.9,292,509,8.5,12.9,54600
244,1400000US51510200107,341,6.7,239,102,10.3,3.7,85000
245,1400000US51510200301,252,9.2,60,192,4.7,13.1,73008
246,1400000US51510200405,755,11.3,309,446,10.6,11.9,61886
247,1400000US51510200500,522,12.4,252,270,12.5,12.3,48423
248,1400000US51510200600,403,8.7,157,246,7.2,10.2,81316
249,1400000US51510200701,0,0,0,0,0,0,133708
250,1400000US51510200702,68,2.5,32,36,2.4,2.7,105208
251,1400000US51510200900,60,1.2,37,23,1.6,0.9,160172
252,1400000US51510201204,96,3.6,27,69,1.8,5.6,60510
253,1400000US51510201600,774,16.7,203,571,9.5,22.8,100234
254,1400000US51510202001,103,5.3,35,68,3.7,6.8,157375
255,,,,,,,,
256,1400000US51610500300,28,0.8,5,23,0.3,1.3,114493
257,1400000US51059415200,121,3.9,21,100,1.6,5.7,81639
258,1400000US51059415300,158,3.9,96,62,5.3,2.8,72794
259,1400000US51059415402,126,4.9,39,87,3.2,6.5,107545
260,1400000US51059415500,481,8.5,110,371,4.1,12.4,97309
261,1400000US51059415600,0,0,0,0,0,0,170952
262,1400000US51059415700,0,0,0,0,0,0,143929
263,1400000US51059415800,73,1.6,0,73,0,3.3,141000
264,1400000US51059415900,0,0,0,0,0,0,159100
265,1400000US51059416100,131,3.7,68,63,4,3.5,128994
266,1400000US51059416200,92,2.1,54,38,2.4,1.8,73858
267,1400000US51059416300,61,2.7,29,32,2.5,3,100170
268,1400000US51059420201,55,1.5,14,41,0.8,2.1,129219
269,1400000US51059420202,5,0.3,5,0,0.5,0,89930
270,1400000US51059420203,105,4.1,68,37,4.9,3.2,123417
271,1400000US51059420300,120,2,90,30,2.7,1.1,113378
272,1400000US51059420501,102,7.4,14,88,2.1,12.3,107404
273,1400000US51059420502,134,9.8,70,64,8.9,11.1,73275
274,1400000US51059420503,265,9.5,160,105,9.2,9.9,75809
275,1400000US51059420600,205,4.9,89,116,3.8,6.1,83446
276,1400000US51059420700,33,0.8,14,19,0.7,1,99100
277,1400000US51059421001,33,1.1,7,26,0.5,1.8,90685
278,1400000US51059421002,244,4.9,75,169,2.9,7.2,96639
279,1400000US51059421101,30,0.5,12,18,0.4,0.6,117375
280,1400000US51059421102,144,4.1,57,87,3.7,4.4,105352
281,1400000US51059421103,79,1.5,29,50,1.2,1.7,113163
282,1400000US51059421300,82,2.2,50,32,2.6,1.8,109479
283,1400000US51059421400,936,16.1,368,568,13.7,18.1,41277
284,1400000US51059421500,1152,17.4,416,736,12.5,22.3,45943
285,1400000US51059421701,613,15,311,302,14.1,16.1,53495
286,1400000US51059421702,186,4.3,113,73,5,3.6,99750
287,1400000US51059421900,160,7.3,83,77,6.7,7.9,62151
288,1400000US51059422000,144,3.9,52,92,2.9,4.9,98224
289,1400000US51059422101,309,4.6,73,236,2,7.4,67151
290,1400000US51059422102,224,3.8,143,81,5.3,2.5,77475
291,1400000US51059422201,59,1.9,30,29,1.9,1.9,129375
292,1400000US51059422202,148,2.8,22,126,0.8,4.6,81889
293,1400000US51059422302,256,4.6,48,208,2,6.8,100162
294,1400000US51059422402,166,3.3,42,124,1.6,5.2,108867
295,1400000US51059422403,17,0.7,17,0,1.3,0,113239
296,1400000US51059430101,82,1.8,44,38,2,1.6,145583
297,1400000US51059430102,122,4.5,48,74,4.2,4.7,104410
298,1400000US51059430201,186,4.1,86,100,4,4.1,106875
299,1400000US51059430202,543,10,341,202,12.7,7.4,122679
300,1400000US51059430400,136,1.9,56,80,1.5,2.3,116519
301,1400000US51059430600,1292,17.1,616,676,16,18.3,81479
302,1400000US51059430700,64,2.3,0,64,0,4.8,102775
303,1400000US51059430801,160,3.8,66,94,3.2,4.4,108429
304,1400000US51059430802,0,0,0,0,0,0,87056
305,1400000US51059430902,83,2.5,58,25,3.2,1.6,105700
306,1400000US51059431001,55,1.2,55,0,2.3,0,103824
307,1400000US51059431002,110,5.3,0,110,0,9.7,84479
308,1400000US51059431300,0,0,0,0,0,0,111283
309,1400000US51059431400,189,4,87,102,3.9,4.1,123526
310,1400000US51059431500,321,6.1,100,221,3.9,8.1,126938
311,1400000US51059431600,395,4.9,212,183,5.7,4.3,67708
312,1400000US51059431802,69,2,69,0,4.3,0,118309
313,1400000US51059432000,210,6.4,101,109,6.3,6.5,112594
314,1400000US51059432100,307,8.6,118,189,7.2,9.7,105801
315,1400000US51059432201,75,4.1,39,36,4.4,3.8,67059
316,1400000US51059432202,197,4.3,37,160,1.6,6.9,120143
317,1400000US51059432401,11,0.3,11,0,0.6,0,146645
318,1400000US51059432402,58,1.2,41,17,1.8,0.6,137745
319,1400000US51059432500,28,0.5,13,15,0.4,0.5,148224
320,1400000US51059432600,188,3.7,51,137,2,5.3,150179
321,1400000US51059432701,77,2.4,38,39,2.4,2.5,136667
322,1400000US51059432800,421,18.7,127,294,12.2,24.4,106731
323,1400000US51059440100,385,5.2,236,149,6.4,3.9,146781
324,1400000US51059440201,157,8,70,87,6.9,9.1,72713
325,1400000US51059440202,90,1.5,62,28,2.2,0.9,97803
326,1400000US51059440300,15,0.5,15,0,1.1,0,146250
327,1400000US51059440501,246,4.8,150,96,6.1,3.6,120485
328,1400000US51059440502,187,9.3,86,101,8.2,10.5,123889
329,1400000US51059440701,34,1.2,34,0,2.5,0,114643
330,1400000US51059440702,23,0.4,0,23,0,0.9,143438
331,1400000US51059440800,271,4.4,140,131,4.9,4,136538
332,1400000US51059450100,132,2.6,33,99,1.4,3.6,85954
333,1400000US51059450300,336,6.8,236,100,9.8,3.9,77331
334,1400000US51059450400,35,1.3,9,26,0.7,1.9,118850
335,1400000US51059450601,49,1.4,0,49,0,2.8,132237
336,1400000US51059450602,545,13.2,114,431,6.8,17.7,62207
337,1400000US51059450701,88,3,88,0,5.6,0,111287
338,1400000US51059450800,33,1,20,13,1.3,0.7,101216
339,1400000US51059450900,126,7.2,64,62,7.7,6.8,122083
340,1400000US51059451000,89,3.7,49,40,3.9,3.4,101797
341,1400000US51059451100,49,2.3,29,20,2.8,1.8,138227
342,1400000US51059451200,0,0,0,0,0,0,190781
343,1400000US51059451400,753,27.8,388,365,28.4,27.2,39538
344,1400000US51059451501,834,14.9,502,332,15.3,14.4,67832
345,1400000US51059451502,141,3.4,30,111,1.5,5.3,70372
346,1400000US51059451601,921,18.2,662,259,18.6,17.1,61752
347,1400000US51059451602,22,0.9,0,22,0,1.5,60156
348,1400000US51059451800,247,7.5,144,103,8.5,6.4,94714
349,1400000US51059452000,299,11,136,163,10.1,11.8,92736
350,1400000US51059452101,266,5.5,31,235,1.6,8.1,88250
351,1400000US51059452200,72,1.2,28,44,0.9,1.6,65255
352,1400000US51059452301,851,24.6,525,326,30,19,55355
353,1400000US51059452302,158,3.4,58,100,2.7,4,60417
354,1400000US51059452400,286,4.2,55,231,1.7,6.4,82455
355,1400000US51059452501,314,8,58,256,3.1,12.7,88109
356,1400000US51059452600,255,5.6,83,172,3.9,7.2,88698
357,1400000US51059452700,696,13.5,358,338,14.7,12.4,59318
358,1400000US51059452801,564,13.7,208,356,9.5,18.5,83115
359,1400000US51059460100,54,1.2,22,32,1,1.4,162344
360,1400000US51059460400,273,5.6,35,238,1.6,8.9,130676
361,1400000US51059460501,102,4.1,25,77,2.1,6,166250
362,1400000US51059460502,129,1.9,12,117,0.4,3.3,170842
363,1400000US51059460701,383,11.4,160,223,9.6,13.3,94550
364,1400000US51059460702,221,5.1,107,114,4.8,5.3,115116
365,1400000US51059460800,116,3.7,51,65,3,4.5,104477
366,1400000US51059460900,8,0.3,0,8,0,0.7,150833
367,1400000US51059461100,388,5.3,121,267,3,7.9,147447
368,1400000US51059461201,35,0.8,0,35,0,1.5,208221
369,1400000US51059461202,569,12.7,114,455,5.8,18,115950
370,1400000US51059461500,217,3.4,121,96,3.5,3.2,150175
371,1400000US51059461602,249,6.4,56,193,2.8,10.3,103887
372,1400000US51059461700,215,3.5,79,136,2.5,4.4,101398
373,1400000US51059461801,91,8.4,30,61,6.3,10.1,95573
374,1400000US51059461802,277,6.2,157,120,8.1,4.7,91383
375,1400000US51059461902,193,10.5,108,85,9.8,11.6,52841
376,1400000US51059470100,34,1.2,0,34,0,2.3,214091
377,1400000US51059470300,33,1,0,33,0,2,228021
378,1400000US51059470400,45,1,11,34,0.5,1.6,187216
379,1400000US51059470500,202,4.1,78,124,3.1,5.1,132213
380,1400000US51059470700,214,4.3,65,149,2.8,5.5,151685
381,1400000US51059470800,34,1.2,9,25,0.7,1.7,134583
382,1400000US51059470900,256,3.6,117,139,3.5,3.6,132536
383,1400000US51059471100,344,5.4,151,193,4.8,5.9,94928
384,1400000US51059471201,111,4.2,12,99,1,7.1,76509
385,1400000US51059471202,105,2.6,73,32,3.7,1.6,95341
386,1400000US51059471301,152,4.9,0,152,0,9.8,94135
387,1400000US51059471304,0,0,0,0,0,0,190929
388,1400000US51059471401,233,7,72,161,5.2,8.4,89531
389,1400000US51059471402,404,11.9,155,249,9.9,13.5,69323
390,1400000US51059480100,17,0.4,7,10,0.3,0.5,184886
391,1400000US51059480201,108,2.7,34,74,1.6,3.8,210625
392,1400000US51059480203,94,4.6,0,94,0,8,102847
393,1400000US51059480300,126,1.7,61,65,1.6,1.9,232500
394,1400000US51059480401,105,2.3,42,63,1.9,2.7,183661
395,1400000US51059480402,119,1.8,35,84,1.1,2.5,189135
396,1400000US51059480502,365,5.9,134,231,4.6,7.1,128942
397,1400000US51059480503,88,2.4,27,61,1.4,3.4,122241
398,1400000US51059480504,40,2.2,14,26,1.8,2.4,141600
399,1400000US51059480505,43,1.5,31,12,2.1,0.8,96359
400,1400000US51059480801,33,0.8,13,20,0.6,1,89182
401,1400000US51059480901,413,6.1,226,187,6.9,5.4,95504
402,1400000US51059480902,220,5.7,76,144,3.5,8.7,77426
403,1400000US51059480903,72,1.9,35,37,1.9,1.8,87661
404,1400000US51059481101,30,1.8,0,30,0,3.9,84654
405,1400000US51059481102,147,5.8,59,88,4.7,6.8,100729
406,1400000US51059481103,153,4.7,65,88,3.8,5.6,80564
407,1400000US51059481105,37,0.7,25,12,1,0.4,175938
408,1400000US51059481106,26,0.5,0,26,0,0.9,163542
409,1400000US51059481201,0,0,0,0,0,0,158355
410,1400000US51059481202,845,14.4,329,516,11,18,67456
411,1400000US51059481400,547,9.3,132,415,4.9,13.1,111161
412,1400000US51059481500,0,0,0,0,0,0,168194
413,1400000US51059481600,78,2.3,8,70,0.5,4,190875
414,1400000US51059481702,263,7.1,157,106,8.6,5.6,88407
415,1400000US51059481900,435,8.1,183,252,7,9.3,102667
416,1400000US51059482001,48,1,15,33,0.6,1.4,178796
417,1400000US51059482100,147,5.5,100,47,7.4,3.6,75590
418,1400000US51059482201,152,7.5,50,102,5.7,8.8,61716
419,1400000US51059482202,161,5.2,48,113,3.3,7,70143
420,1400000US51059482203,9,0.3,9,0,0.6,0,120833
421,1400000US51059482302,988,24.4,569,419,25.7,22.8,64892
422,1400000US51059482303,104,3.5,44,60,3.2,3.7,101639
423,1400000US51059482400,18,0.8,11,7,1.1,0.6,172083
424,1400000US51059482501,174,3,71,103,2.6,3.3,100472
425,1400000US51059482503,71,1.5,15,56,0.6,2.3,165250
426,1400000US51059482504,0,0,0,0,0,0,170134
427,1400000US51059482601,80,1.1,28,52,0.8,1.5,134150
428,1400000US51059482602,189,2.8,75,114,2.4,3.2,152154
429,1400000US51059490101,280,5.3,108,172,4.5,6.1,121250
430,1400000US51059490103,153,2.9,100,53,3.5,2.1,107411
431,1400000US51059490502,328,5.4,109,219,3.7,7,152809
432,1400000US51059491000,21,1.1,14,7,1.6,0.7,194167
433,1400000US51059491101,11,0.3,0,11,0,0.6,163828
434,1400000US51059491102,0,0,0,0,0,0,118611
435,1400000US51059491201,140,2.4,43,97,1.5,3.3,77500
436,1400000US51059491301,132,1.9,50,82,1.5,2.3,120547
437,1400000US51059491302,237,6.4,149,88,8.8,4.4,92708
438,1400000US51059491303,284,7.5,190,94,9.3,5.5,60737
439,1400000US51059491402,306,7.2,176,130,8.1,6.3,94884
440,1400000US51059491403,79,2,31,48,1.5,2.4,174770
441,1400000US51059491404,158,4,39,119,2,5.9,117321
442,1400000US51059491405,0,0,0,0,0,0,148984
443,1400000US51059491502,44,0.6,22,22,0.6,0.6,170283
444,1400000US51059491601,617,12.7,248,369,11.7,13.6,66339
445,1400000US51059491602,414,7.6,213,201,7.7,7.5,114118
446,1400000US51059491701,83,2.7,12,71,0.8,4.2,93239
447,1400000US51059491702,490,7.5,208,282,6.9,8.1,82060
448,1400000US51059491704,324,8.1,78,246,4.1,11.7,90000
449,1400000US51059491705,445,12,174,271,10.4,13.4,160043
450,1400000US51059491802,40,1.6,30,10,2.5,0.7,111031
451,1400000US51059491803,342,5.3,135,207,4.2,6.4,89639
452,1400000US51059492000,136,2.1,89,47,2.7,1.4,181833
453,1400000US51059492100,311,4.7,174,137,5.3,4.1,185000
454,1400000US51059492201,96,3.7,15,81,1.3,5.8,223032
455,1400000US51059492203,0,0,0,0,0,0,194659
456,1400000US51059492300,184,5.4,96,88,5.5,5.3,116591
457,1400000US51059492400,251,5.2,149,102,6.1,4.4,88269
458,1400000US51059492500,166,3.9,111,55,5.3,2.5,173854
459,1400000US51059980200,0,-,0,0,-,-,-
460,1400000US51059980300,0,-,0,0,-,-,-
461,1400000US51013100200,103,1.7,0,103,0,3.4,170185
462,1400000US51013100300,67,1.2,20,47,0.8,1.7,193036
463,1400000US51013100500,193,4.3,89,104,3.9,4.7,174792
464,1400000US51013100600,131,4.7,41,90,3.2,6.1,103393
465,1400000US51013100700,103,2.2,32,71,1.5,2.6,105089
466,1400000US51013100900,195,4.8,108,87,6.1,3.8,100476
467,1400000US51013101000,127,4,63,64,4.3,3.8,134630
468,1400000US51013101100,85,1.6,38,47,1.5,1.7,140417
469,1400000US51013101200,162,4.8,45,117,2.9,6.4,149271
470,1400000US51013101300,102,1.7,37,65,1.1,2.4,138558
471,1400000US51013101402,117,4.6,0,117,0,9.2,121636
472,1400000US51013101403,228,4.5,89,139,3.4,5.8,99595
473,1400000US51013101404,144,4.2,87,57,5.3,3.2,102819
474,1400000US51013101500,493,6.6,251,242,7.3,6.1,102205
475,1400000US51013101601,127,8.4,78,49,10.3,6.5,102159
476,1400000US51013101603,237,7.7,138,99,7.9,7.3,96941
477,1400000US51013101701,306,10.7,79,227,5.8,15,89412
478,1400000US51013101702,694,17.5,363,331,20.3,15.2,66974
479,1400000US51013101801,43,2.1,0,43,0,4.6,109676
480,1400000US51013101802,247,4.5,120,127,4,5.1,102169
481,1400000US51013101803,224,5.2,129,95,5.7,4.7,71963
482,1400000US51013102001,144,9.1,47,97,5.7,12.7,46688
483,1400000US51013102002,212,14.3,117,95,14.9,13.6,60956
484,1400000US51013102003,446,12,232,214,11.5,12.7,41392
485,1400000US51013102100,380,16,53,327,5.5,23.1,97115
486,1400000US51013102200,1663,24.7,660,1003,19.3,30.4,45581
487,1400000US51013102302,522,11.8,250,272,10.5,13.2,87381
488,1400000US51013102400,235,6.7,91,144,5.1,8.4,76836
489,1400000US51013102500,146,3.1,95,51,4,2.2,83322
490,1400000US51013102600,95,2.8,67,28,4.7,1.5,80161
491,1400000US51013102701,650,18,330,320,16.7,19.7,49412
492,1400000US51013102801,242,4.2,104,138,3.4,5.2,60881
493,1400000US51013102802,55,4.6,4,51,0.7,8.5,130987
494,1400000US51013102901,68,2.7,56,12,5,0.8,101012
495,1400000US51013103000,159,4.8,38,121,2.7,6.3,109673
496,1400000US51013103100,489,10.6,127,362,5.9,14.7,75700
497,1400000US51013103200,506,10,209,297,8.2,11.8,71451
498,1400000US51013103300,523,22.6,346,177,29,15.8,58173
499,1400000US51013103401,0,0,0,0,0,0,112563
500,1400000US51013103501,240,7.6,84,156,6.6,8.3,82183
501,1400000US51013103502,560,21.6,134,426,11.2,30.6,87038
502,1400000US51013103503,182,5.1,26,156,1.3,9.4,85361
503,1400000US51013103601,29,1.3,18,11,1.6,0.9,116184
504,1400000US51013103700,80,3.5,46,34,3.9,3.1,163889
505,1400000US51013103800,376,8.7,195,181,8.6,8.9,75179
506,1400000US51013980100,0,-,0,0,-,-,-
507,1400000US51013980200,0,0,0,0,0,-,67361
508,1400000US51059491103,730,10.7,381,349,10.5,11.1,94538
509,1400000US51510201300,264,8.1,129,135,7.8,8.4,96250
510,1400000US51510201400,260,6.2,156,104,7.7,4.8,99531
511,1400000US51510201500,85,2.7,60,25,4.1,1.5,145515
512,1400000US51510201801,306,6.3,144,162,5.9,6.6,103727
513,1400000US51510201802,261,13.8,77,184,9.4,17.1,137396
514,1400000US51510201900,31,2,8,23,1,2.9,104000
515,1400000US51510202002,140,6,45,95,4.3,7.3,89801
516,1400000US51510200102,264,6.5,115,149,5.1,8.2,70000
517,1400000US51510200104,546,15.3,222,324,13,17.5,62845
518,1400000US51510200105,458,11.7,274,184,12.3,10.9,47022
519,1400000US51510200106,98,3.8,12,86,1.1,5.8,76848
520,1400000US51510200201,217,6.9,32,185,2.1,11.8,74800
521,1400000US51510200202,39,2.6,0,39,0,4.5,146944
522,1400000US51510200302,202,4.9,88,114,5,4.9,99539
523,1400000US51510200303,380,8.5,119,261,5.8,10.7,59383
524,1400000US51510200403,14,1.1,14,0,1.9,0,106711
525,1400000US51510200404,25,0.7,0,25,0,1.3,137240
526,1400000US51510200406,533,12.1,231,302,10.7,13.5,58182
527,1400000US51510200407,166,4.2,55,111,3.2,5,64038
528,1400000US51510200703,389,15.4,171,218,12.7,18.5,96354
529,1400000US51510200801,60,2.2,10,50,0.7,3.7,132760
530,1400000US51510200802,211,7.3,103,108,6.8,7.9,86726
531,1400000US51510201000,100,3.9,25,75,2.3,5,79437
532,1400000US51510201100,54,1.9,28,26,2.1,1.6,130350
533,1400000US51510201202,62,1.9,20,42,1.1,2.9,89147
534,1400000US51510201203,955,17.7,454,501,15.7,20,44264
535,,,,,,,,
536,,,,,,,,
537,,,,,,,,
538,,,,,,,,
539,1400000US51610500100,61,2.4,28,33,2.1,2.8,135361
540,1400000US51610500200,457,8.4,106,351,4.4,11.5,92188
541,1400000US51059420400,117,5.4,64,53,5.8,5,61809
542,1400000US51059482002,55,1.7,0,55,0,3.4,109750
543,1400000US24031700105,111,1.6,13,98,0.4,2.8,101015
544,1400000US24031700304,581,8.2,288,293,8.1,8.3,99353
545,1400000US24031700607,216,2.6,121,95,2.9,2.2,143872
546,1400000US24031700611,12,0.2,0,12,0,0.4,152552
547,1400000US24031700710,345,5.3,183,162,5.3,5.3,90029
548,1400000US24031700718,80,2,0,80,0,4,110262
549,1400000US24031700723,355,12.8,141,214,11.9,13.4,50517
550,1400000US24031700815,577,7.3,414,163,10.5,4.1,77167
551,1400000US24031700820,405,14.7,144,261,10,20,71979
552,1400000US24031700824,102,3.8,66,36,4.9,2.7,151515
553,1400000US24033803001,202,7,84,118,6.4,7.6,69621
554,1400000US24033803002,235,8.4,73,162,5.7,10.7,63875
555,1400000US24033803100,355,15.6,217,138,20.8,11.1,55582
556,1400000US24033803200,473,16.2,280,193,18.7,13.6,51303
557,1400000US24033803512,141,2.2,81,60,3,1.7,82611
558,1400000US24033803519,197,5.8,39,158,2.8,7.8,67652
559,1400000US24033803525,369,13.1,169,200,12.8,13.3,50571
560,1400000US24033803613,198,4.6,146,52,6.7,2.5,51435
561,1400000US24033804001,627,13,244,383,10.6,15.2,39028
562,1400000US24033804400,312,12.7,125,187,11.1,14,51750
563,1400000US24033804900,705,21.3,161,544,13.8,25.3,41696
564,1400000US24033805601,1624,26.8,989,635,22.9,36.6,45581
565,1400000US24033805904,613,19.3,398,215,24.3,14,56750
566,1400000US24033806200,120,2.9,12,108,0.6,5.1,65581
567,1400000US24033806602,539,12.1,240,299,11.2,12.8,65154
568,1400000US24033806712,61,2.1,14,47,1,3.2,70422
569,1400000US24033807304,108,5.3,64,44,5.4,5.1,83163
570,1400000US24031700826,200,3.4,17,183,0.7,5.4,111601
571,1400000US24031700828,42,1.6,0,42,0,2.7,139231
572,1400000US24031700829,32,1.1,15,17,1.2,1.1,120229
573,1400000US24031700830,52,2.9,16,36,2.1,3.5,65000
574,1400000US24031700901,365,10.7,133,232,9.2,11.7,58911
575,1400000US24031701002,13,0.4,0,13,0,0.7,193393
576,1400000US24031701102,295,5.2,80,215,2.8,7.9,79701
577,1400000US24031701210,52,1.3,22,30,1.1,1.4,164688
578,1400000US24031701215,211,5.2,37,174,2.2,7.5,84841
579,1400000US24031701304,80,1.3,38,42,1.3,1.2,112364
580,1400000US24031701313,123,3.2,0,123,0,6.7,111429
581,1400000US24031701409,82,1.8,41,41,2,1.7,144132
582,1400000US24031701422,528,26.8,212,316,23,30.2,43333
583,1400000US24031701508,145,3.8,51,94,3.5,4,44517
584,1400000US24031701601,56,2.4,11,45,1,3.6,44329
585,1400000US24031701900,382,12.3,122,260,6.9,19.5,55104
586,1400000US24031702102,43,1.5,35,8,2.6,0.5,114318
587,1400000US24031702500,338,8.1,132,206,6.6,9.5,57067
588,1400000US24031703201,511,6.9,280,231,7.7,6.2,98641
589,1400000US24031703209,1258,23.2,517,741,22.4,23.8,52555
590,1400000US24031703218,43,2.4,14,29,2.3,2.5,53083
591,1400000US24031703301,278,6.4,133,145,6,6.7,78182
592,1400000US24031703402,210,6.1,109,101,6.2,6.1,83403
593,1400000US24031703602,90,3.3,0,90,0,6.2,109766
594,1400000US24031703902,1043,15.6,339,704,10,21.3,63698
595,1400000US24031704403,27,1.8,27,0,4.6,0,75242
596,1400000US24031704804,24,2.1,9,15,1.9,2.3,112431
597,1400000US24031705300,50,2.6,16,34,1.7,3.4,"250,000+"
598,1400000US24031705601,43,1.6,17,26,1.4,1.7,177750
599,1400000US24031705602,299,6.8,96,203,5.2,8.1,76995
600,1400000US24031705701,184,4.3,83,101,4.4,4.3,131500
601,1400000US24031705901,44,1.1,0,44,0,2,186513
602,1400000US24031706011,151,2.9,48,103,1.9,3.9,185066
603,1400000US24033800106,63,2.3,24,39,1.9,2.7,92031
604,1400000US24033800209,352,9.5,194,158,10.1,8.8,48464
605,1400000US24033800214,165,6.2,51,114,4,8.2,60833
606,1400000US24033800408,194,3,105,89,3.1,2.8,119063
607,1400000US24033800413,297,8.2,111,186,6.3,9.8,69135
608,1400000US24033800514,119,2.9,119,0,5.6,0,164518
609,1400000US24033800519,100,2.3,10,90,0.5,4.2,132986
610,1400000US24033800704,114,2.4,30,84,1.6,2.9,90271
611,1400000US24033801005,36,0.8,0,36,0,1.5,113750
612,1400000US24033801006,112,2.9,72,40,3.8,2,112689
613,1400000US24033801209,285,6.3,68,217,3.6,8.2,93108
614,1400000US24033801216,159,4.7,79,80,4.3,5,86797
615,1400000US24033801308,84,2,41,43,2,2.1,108446
616,1400000US24033801313,12,0.4,0,12,0,0.7,106635
617,1400000US24033801409,29,1.1,7,22,0.6,1.6,65919
618,1400000US24033801702,683,18.4,350,333,21.1,16.3,49403
619,1400000US24033801801,183,8.9,95,88,11.9,6.9,56047
620,1400000US24033801805,32,1.4,7,25,0.6,2.3,49583
621,1400000US24033802104,40,2,29,11,3.2,1,51542
622,1400000US24033802203,219,4.7,92,127,4.2,5.1,54393
623,1400000US24033802406,207,9.9,77,130,8,11.6,64531
624,1400000US24033802600,145,4.9,20,125,1.3,8.6,49336
625,1400000US24031700308,287,4.6,115,172,3.8,5.2,93201
626,1400000US24031700309,705,13.6,189,516,7.5,19.6,77215
627,1400000US24031700310,221,4.6,115,106,5,4.3,77681
628,1400000US24031700311,69,1.3,9,60,0.3,2.3,126970
629,1400000US24031700312,135,2.9,85,50,3.6,2.2,123113
630,1400000US24031700400,104,4.7,59,45,5,4.3,149779
631,1400000US24031700500,121,1.9,77,44,2.5,1.4,105481
632,1400000US24031700604,158,2.4,83,75,2.5,2.3,165893
633,1400000US24031700606,24,0.5,24,0,1.1,0,136367
634,1400000US24031700608,230,3.8,140,90,4.7,3,200952
635,1400000US24031700610,27,1.4,14,13,1.5,1.3,131053
636,1400000US24031700613,171,2.7,92,79,2.8,2.6,130268
637,1400000US24031700614,147,3.1,54,93,2.3,3.9,71563
638,1400000US24031700615,28,0.9,16,12,1,0.8,157031
639,1400000US24031700616,11,0.3,0,11,0,0.5,137542
640,1400000US24031700704,138,4.8,0,138,0,9.5,68523
641,1400000US24031700706,341,10.5,187,154,12.6,8.7,55720
642,1400000US24031700711,262,4.6,117,145,4.5,4.8,94861
643,1400000US24031700713,522,9.7,218,304,8,11.6,53431
644,1400000US24031700715,322,5.4,85,237,2.9,7.9,93990
645,1400000US24031700716,728,9.2,371,357,9.4,9,82917
646,1400000US24031700717,822,14,442,380,14.5,13.4,65029
647,1400000US24031700719,1086,16.5,452,634,13.4,19.7,62303
648,1400000US24031700720,333,10.1,194,139,11.9,8.4,85705
649,1400000US24031700721,221,9.6,59,162,5.7,12.6,58109
650,1400000US24031700722,150,3.2,81,69,3.4,3.1,76971
651,1400000US24031700724,678,23.9,252,426,17.8,30,47210
652,1400000US24031700810,181,3.6,61,120,2.5,4.5,96462
653,1400000US24031700811,322,7.2,146,176,7.4,7,90395
654,1400000US24031700812,62,1.4,25,37,1.2,1.7,87614
655,1400000US24031700101,89,2.2,57,32,2.7,1.6,156964
656,1400000US24031700103,80,1.4,19,61,0.7,2.1,169881
657,1400000US24031700104,286,6,85,201,3.8,7.9,115536
658,1400000US24031700204,12,0.6,2,10,0.2,1,86250
659,1400000US24031700205,149,2.6,45,104,1.6,3.5,133942
660,1400000US24031700206,34,0.6,34,0,1.2,0,115323
661,1400000US24031700207,701,12.5,307,394,11.3,13.6,92966
662,1400000US24031700208,22,1.1,15,7,1.6,0.7,112396
663,1400000US24031700306,301,4.3,188,113,5.7,3.1,100461
664,1400000US24031700813,552,9.7,324,228,11.1,8.1,66801
665,1400000US24031700816,315,3.9,145,170,3.7,4.1,69147
666,1400000US24031700817,354,7.3,163,191,8,6.9,81011
667,1400000US24031700818,733,12,378,355,11.7,12.3,63003
668,1400000US24031700819,174,2.7,146,28,4.6,0.9,88636
669,1400000US24031700822,121,7.5,20,101,3.3,9.9,61557
670,1400000US24031700823,168,5.4,69,99,4.5,6.2,108904
671,1400000US24033803300,425,10.2,138,287,7.3,12.6,61635
672,1400000US24033803401,189,13.5,73,116,11.2,15.4,49375
673,1400000US24033803402,789,16.6,292,497,14.5,18.2,54680
674,1400000US24033803508,1488,31.8,740,748,36.8,28.1,39864
675,1400000US24033803509,246,9.5,114,132,9.3,9.7,46333
676,1400000US24033803513,179,3.8,48,131,2.3,5,63939
677,1400000US24033803514,270,6.6,11,259,0.7,10.4,77284
678,1400000US24033803516,76,1.6,0,76,0,2.9,96929
679,1400000US24033806711,333,9.1,120,213,7.1,10.8,66944
680,1400000US24033806713,731,20.7,308,423,20.5,20.8,43646
681,1400000US24033806714,147,4.8,15,132,0.9,9.7,54816
682,1400000US24033806800,167,4.3,82,85,4.1,4.5,95450
683,1400000US24033806900,293,6.9,110,183,5.6,8,68958
684,1400000US24033807000,1457,27.9,934,523,32.9,22,60714
685,1400000US24033807102,257,9.6,232,25,15.3,2.2,71528
686,1400000US24033807200,2471,67.1,1491,980,70,63.2,18441
687,1400000US24033807301,812,23.9,480,332,27.4,20.1,63194
688,1400000US24033807305,189,5.4,60,129,3.3,7.6,68214
689,1400000US24033807404,122,2.7,59,63,2.5,3,80129
690,1400000US24033807407,112,1.9,0,112,0,3.7,77593
691,1400000US24033807408,108,2,38,70,1.5,2.6,80386
692,1400000US24033807409,468,13.8,227,241,12.5,15.3,72551
693,1400000US24033807410,252,7.1,129,123,7.1,7,52292
694,1400000US24033803520,22,0.5,0,22,0,0.9,125909
695,1400000US24033803521,145,3.2,33,112,2,3.9,104271
696,1400000US24033803522,100,2.6,26,74,1.6,3.4,88750
697,1400000US24033803523,150,3.9,41,109,2.5,5,131250
698,1400000US24033803524,25,0.8,25,0,1.7,0,70878
699,1400000US24033803526,120,3.7,43,77,2.7,4.7,91719
700,1400000US24033803527,70,2.2,14,56,1,3.2,93125
701,1400000US24033803601,152,4.3,90,62,5.6,3.2,88397
702,1400000US24033803602,242,14,89,153,13.1,14.6,63214
703,1400000US24033803605,720,10.5,347,373,10.6,10.4,75000
704,1400000US24033803606,156,3,39,117,1.5,4.5,70446
705,1400000US24033803608,323,6.3,30,293,1.3,10.7,73068
706,1400000US24033803610,247,8.2,93,154,6.2,10,56071
707,1400000US24033803612,437,14.9,212,225,16.7,13.4,46111
708,1400000US24033803700,193,8.2,56,137,4.7,11.8,59813
709,1400000US24033803801,291,13.8,124,167,11.8,15.9,55870
710,1400000US24033803803,526,9.2,173,353,5.7,13.2,60481
711,1400000US24033803900,327,7.9,166,161,7.4,8.6,65890
712,1400000US24033804002,498,12.3,180,318,8.5,16.3,54934
713,1400000US24033804101,140,4.7,47,93,3,6.6,66654
714,1400000US24033804102,987,14.8,278,709,9.6,18.8,60211
715,1400000US24033804200,286,9.5,130,156,8.9,10.1,88245
716,1400000US24033804300,681,18.1,347,334,19.6,16.8,50877
717,1400000US24033804600,412,14,217,195,15.2,12.8,52813
718,1400000US24033804700,490,13.5,213,277,11.1,16.2,69479
719,1400000US24033804801,378,16,187,191,15.5,16.5,41549
720,1400000US24033804802,589,21.6,164,425,11.9,31.4,34909
721,1400000US24033805000,724,14.2,170,554,8.6,17.8,51765
722,1400000US24033805101,242,6.5,140,102,6.8,6.1,44844
723,1400000US24033805201,933,22.9,494,439,25.3,20.7,50897
724,1400000US24033805202,510,13,245,265,11.5,14.8,52603
725,1400000US24033805500,332,10.2,147,185,8.6,12,62917
726,1400000US24033805602,1023,21.3,624,399,18.7,27.2,50621
727,1400000US24033805700,731,13.7,431,300,14.5,12.7,55208
728,1400000US24033805801,854,17.6,327,527,13.1,22.5,73045
729,1400000US24033805802,505,13.6,265,240,12.9,14.5,74250
730,1400000US24033805906,476,16.1,203,273,12.9,19.8,47716
731,1400000US24033805907,561,14.7,299,262,16.5,13,50036
732,1400000US24033805908,388,16.7,163,225,13.3,20.4,43478
733,1400000US24033805909,840,19.8,514,326,22.7,16.5,44231
734,1400000US24033806000,754,16.2,396,358,16.9,15.6,46821
735,1400000US24033806100,157,3.7,54,103,2.4,5.1,74441
736,1400000US24033806300,117,5.9,71,46,7.1,4.7,52404
737,1400000US24033806400,151,4.6,67,84,4,5.2,128065
738,1400000US24033806501,603,11.6,275,328,9.5,14.3,49784
739,1400000US24033806601,659,15.7,259,400,11.5,20.6,55625
740,1400000US24033806706,566,16.1,96,470,6,24.5,72055
741,1400000US24033806708,660,13.6,200,460,9.5,16.7,59917
742,1400000US24033806710,90,1.4,54,36,2,1,90052
743,1400000US24033803607,67,2,16,51,1,3.1,100982
744,1400000US24031701417,591,10.6,264,327,10.4,10.8,59217
745,1400000US24033801908,82,2.2,45,37,2.6,1.8,56984
746,1400000US24033807405,230,4.6,187,43,7.7,1.7,75607
747,1400000US24031704502,72,2.7,27,45,2.3,3.1,175742
748,1400000US24031700832,137,5.1,64,73,4.6,5.7,67241
749,1400000US24031700833,360,8.4,153,207,7.6,9,71545
750,1400000US24031700834,550,10.9,347,203,13.2,8.4,83413
751,1400000US24031700835,34,0.7,34,0,1.5,0,126652
752,1400000US24031700902,92,2.8,34,58,2.1,3.6,58966
753,1400000US24031700903,204,12.7,71,133,10.4,14.4,66912
754,1400000US24031700904,152,5.8,67,85,5.2,6.4,59478
755,1400000US24031700905,92,2.3,24,68,1.2,3.2,72025
756,1400000US24031701001,305,5.9,136,169,5.6,6.1,91705
757,1400000US24031701004,333,6.5,159,174,6.4,6.7,94063
758,1400000US24031701005,8,0.3,8,0,0.6,0,130144
759,1400000US24031701006,134,2.5,46,88,1.8,3,129063
760,1400000US24031701007,75,2.4,36,39,2.8,2.1,96250
761,1400000US24031701101,253,5.9,119,134,6.1,5.8,89939
762,1400000US24031701201,184,3.5,51,133,2,4.9,80509
763,1400000US24031701202,122,4.7,48,74,3.8,5.5,114635
764,1400000US24031701205,220,3.5,108,112,3.6,3.4,163715
765,1400000US24031701206,132,2.1,78,54,2.5,1.7,134531
766,1400000US24031701211,148,2.6,43,105,1.7,3.5,110938
767,1400000US24031701212,56,2,37,19,2.7,1.4,130743
768,1400000US24031701213,195,3.9,63,132,2.8,4.7,102748
769,1400000US24031701214,64,2.6,23,41,2.3,2.8,80679
770,1400000US24031701216,133,4,74,59,4.7,3.3,91071
771,1400000US24031701218,98,5.1,0,98,0,8.9,62870
772,1400000US24031701219,332,10.8,50,282,3.3,18.1,64707
773,1400000US24031701220,146,3.5,65,81,3.3,3.7,185804
774,1400000US24031701221,301,6.6,62,239,2.9,9.9,120855
775,1400000US24031701303,41,1.1,25,16,1.3,0.8,129318
776,1400000US24031701306,23,0.7,23,0,1.6,0,129844
777,1400000US24031701307,53,1.5,34,19,1.9,1.1,144511
778,1400000US24031701308,134,4.4,48,86,2.9,6.2,175982
779,1400000US24031701312,148,2.5,63,85,2.3,2.7,136563
780,1400000US24031701314,70,2.5,16,54,1.2,3.6,85588
781,1400000US24031701315,76,1.8,24,52,1.2,2.4,88529
782,1400000US24031701316,139,2.5,41,98,1.6,3.2,114083
783,1400000US24031701317,0,0,0,0,0,0,179280
784,1400000US24031701408,345,5.3,212,133,6.4,4.2,130281
785,1400000US24031701410,840,11.3,331,509,10,12.3,79924
786,1400000US24031701414,781,10.6,268,513,8.2,12.5,66920
787,1400000US24031701415,366,4.9,112,254,3.4,6,93144
788,1400000US24031701418,0,0,0,0,0,0,108087
789,1400000US24031701420,363,5.3,215,148,6.5,4.1,66881
790,1400000US24031701421,343,20.2,135,208,19.5,20.7,69833
791,1400000US24031701423,275,5.5,155,120,7.1,4.3,70857
792,1400000US24031701503,57,0.8,11,46,0.3,1.4,96657
793,1400000US24031701505,754,11.1,273,481,8.5,13.5,74583
794,1400000US24031701506,111,2.3,63,48,2.8,1.9,123309
795,1400000US24031701507,245,4.8,68,177,2.7,7,131875
796,1400000US24031701509,880,15.8,436,444,16.7,15,49044
797,1400000US24031701602,771,12.8,294,477,9.3,16.6,64363
798,1400000US24031701701,156,5,92,64,5.9,4,61452
799,1400000US24031701702,376,17,97,279,9.6,23.1,56949
800,1400000US24031701703,158,4.1,44,114,2.6,5.4,83472
801,1400000US24031701704,150,5.9,52,98,4.2,7.4,81903
802,1400000US24031701800,538,12.5,278,260,12.8,12.1,65556
803,1400000US24031702000,824,17.1,306,518,11.9,23.1,47034
804,1400000US24031702101,621,10.6,337,284,11.1,10,59429
805,1400000US24031701407,7,0.1,7,0,0.2,0,122813
806,1400000US24031702200,138,3.4,16,122,0.8,5.8,103551
807,1400000US24031702301,512,12.1,131,381,6.2,18,64192
808,1400000US24031702302,319,7.6,72,247,3.7,11.2,65250
809,1400000US24031702401,77,3.2,39,38,3.7,2.8,121118
810,1400000US24031702402,531,13.2,186,345,9.4,17,66017
811,1400000US24031702601,476,10.9,274,202,13.1,8.8,66744
812,1400000US24031702602,877,20,403,474,20.3,19.7,56635
813,1400000US24031702700,670,11.4,266,404,9.1,13.7,77050
814,1400000US24031702800,333,7.4,79,254,3.5,11.4,85290
815,1400000US24031702900,32,0.6,19,13,0.8,0.5,101905
816,1400000US24031703000,78,4.3,36,42,4,4.5,92857
817,1400000US24031703100,233,5.5,121,112,5.7,5.3,99464
818,1400000US24031703202,411,7.1,223,188,7.8,6.5,100417
819,1400000US24031703206,244,6.5,133,111,6.8,6.1,94250
820,1400000US24031703207,735,14.7,288,447,11.6,17.7,54205
821,1400000US24031703208,110,2.2,49,61,2,2.3,111835
822,1400000US24031703210,139,4.1,67,72,4,4.2,105313
823,1400000US24031703212,320,4.1,106,214,2.9,5,106554
824,1400000US24031703213,1012,18.2,479,533,18.5,18,41639
825,1400000US24031703214,895,13.8,325,570,10,17.6,47952
826,1400000US24031703215,210,7.5,84,126,6.1,8.7,85083
827,1400000US24031703216,275,8,91,184,6.5,9,51034
828,1400000US24031703219,121,3.6,23,98,2,4.4,52098
829,1400000US24031703220,613,13.6,228,385,11.9,14.8,51935
830,1400000US24031703221,441,8.9,258,183,10.8,7.2,103068
831,1400000US24031703302,327,7.7,120,207,5.9,9.5,80300
832,1400000US24031703401,451,8.4,212,239,7.9,8.9,73643
833,1400000US24031703403,608,18.1,397,211,22.1,13.5,68750
834,1400000US24031703404,260,8.9,128,132,8.4,9.4,57098
835,1400000US24031703501,1162,19,580,582,18.6,19.3,51429
836,1400000US24031703502,590,18.7,182,408,12.2,24.5,65069
837,1400000US24031703601,166,3.9,37,129,2.2,5.1,70795
838,1400000US24031703701,209,5.9,119,90,6.4,5.4,63228
839,1400000US24031703702,19,0.5,4,15,0.2,0.8,80536
840,1400000US24031703800,387,12.3,218,169,14.8,10.1,54271
841,1400000US24031703901,110,3.8,38,72,2.8,4.7,107589
842,1400000US24031704000,389,6.5,150,239,5.5,7.3,71750
843,1400000US24031704100,117,2.6,19,98,0.9,4,166014
844,1400000US24031704200,152,8.2,68,84,7.3,9.1,88558
845,1400000US24031704300,127,3.3,63,64,3.7,3,130989
846,1400000US24031704401,237,7.6,183,54,11.8,3.4,135536
847,1400000US24031704404,38,0.7,26,12,1,0.5,143194
848,1400000US24031704501,122,3.9,17,105,1.2,6.4,112037
849,1400000US24031704503,0,0,0,0,0,0,173274
850,1400000US24031704600,97,1.9,73,24,2.9,0.9,135278
851,1400000US24031704700,26,0.7,8,18,0.4,0.9,221641
852,1400000US24031704803,77,2.4,24,53,1.9,2.7,69949
853,1400000US24031704805,320,24.1,124,196,22.3,25.4,60250
854,1400000US24031704806,169,6,84,85,5.6,6.4,79861
855,1400000US24031705000,250,5.7,131,119,5.8,5.5,131897
856,1400000US24031705100,92,1.8,33,59,1.4,2.1,161111
857,1400000US24031705200,81,2.5,27,54,1.8,3.2,190909
858,1400000US24031705400,33,1.2,21,12,1.6,0.8,204911
859,1400000US24031705501,332,12.9,147,185,15.5,11.4,99600
860,1400000US24031705502,109,2.7,45,64,2.2,3.2,162188
861,1400000US24031705702,54,1.3,12,42,0.6,1.9,183792
862,1400000US24031705800,86,1.5,37,49,1.3,1.6,179022
863,1400000US24031705902,20,0.5,11,9,0.5,0.4,180417
864,1400000US24031705903,171,3.9,83,88,3.9,3.9,193173
865,1400000US24031706005,133,3,96,37,4.5,1.7,195441
866,1400000US24031706007,143,2.1,51,92,1.6,2.5,190801
867,1400000US24031706008,14,0.3,0,14,0,0.5,"250,000+"
868,1400000US24031706009,94,1.7,18,76,0.7,2.8,235833
869,1400000US24031706010,143,5,43,100,3.3,6.4,129231
870,1400000US24031706012,305,8.7,90,215,6.4,10.3,62042
871,1400000US24031706013,46,1.7,46,0,3.5,0,205045
872,1400000US24033800102,128,4.3,90,38,6.3,2.4,61085
873,1400000US24033800103,135,6.3,82,53,7.1,5.5,56659
874,1400000US24033800105,124,3.6,71,53,4.4,2.9,67574
875,1400000US24033800108,604,17.9,169,435,12.3,21.7,57400
876,1400000US24033800109,222,5.1,0,222,0,9.3,64089
877,1400000US24033800203,137,2.9,61,76,2.6,3.2,116359
878,1400000US24033800206,198,4.6,48,150,2.3,6.8,77773
879,1400000US24033800208,234,3.7,130,104,4.5,3,87108
880,1400000US24033800210,464,15.7,235,229,14.4,17.2,57643
881,1400000US24033800211,222,7.9,59,163,4.2,11.6,54297
882,1400000US24033800212,123,4.7,39,84,3.9,5.2,87206
883,1400000US24033800213,315,8,213,102,11.7,4.8,71940
884,1400000US24033800215,71,2.6,48,23,4.2,1.5,68090
885,1400000US24033800401,171,6.5,9,162,0.7,11.9,113295
886,1400000US24033800402,8,0.2,0,8,0,0.3,92463
887,1400000US24033800403,65,1.6,52,13,2.7,0.6,115565
888,1400000US24033800409,108,1.7,43,65,1.3,2,115083
889,1400000US24033800410,121,2.2,71,50,2.7,1.7,120243
890,1400000US24033800411,218,5.2,68,150,3.1,7.3,88182
891,1400000US24033800412,236,7.1,124,112,8.3,6.1,54819
892,1400000US24033800504,256,5.3,97,159,4.3,6.2,106250
893,1400000US24033800505,219,8.6,105,114,8.3,8.8,90096
894,1400000US24033800507,61,2.3,23,38,1.7,2.9,96653
895,1400000US24033800509,259,3.1,142,117,4,2.5,105774
896,1400000US24033800511,124,2.5,115,9,5,0.3,85085
897,1400000US24033800513,172,3.2,72,100,2.6,3.9,92074
898,1400000US24033800515,274,7.4,165,109,10.4,5.1,81937
899,1400000US24033800516,199,6.2,112,87,6.8,5.5,81026
900,1400000US24033800517,60,1.2,60,0,2.6,0,142135
901,1400000US24033800518,35,1.2,0,35,0,2.3,157083
902,1400000US24033800520,43,2.1,43,0,5,0,100167
903,1400000US24033800601,99,5.1,34,65,3.4,7,98447
904,1400000US24033800604,96,5.6,0,96,0,9.8,100809
905,1400000US24033800605,155,3.8,87,68,4.9,2.9,102244
906,1400000US24033800606,177,4,50,127,2.4,5.3,77485
907,1400000US24033800607,96,1.7,0,96,0,3,133281
908,1400000US24033800608,61,2,39,22,2.7,1.3,143750
909,1400000US24033800701,17,0.4,17,0,0.8,0,118169
910,1400000US24033800705,42,1,0,42,0,2.1,133485
911,1400000US24033800706,30,0.8,30,0,1.7,0,130147
912,1400000US24033800707,236,8.8,138,98,11.4,6.6,80568
913,1400000US24033800800,107,3.1,64,43,3.4,2.7,111314
914,1400000US24033800900,68,4.3,26,42,3.3,5.4,49643
915,1400000US24033801003,117,3.4,73,44,4.3,2.4,79519
916,1400000US24033801004,50,1.4,0,50,0,2.7,106709
917,1400000US24033801104,0,0,0,0,0,0,52382
918,1400000US24033801207,97,2.4,22,75,1.2,3.4,119087
919,1400000US24033801208,0,0,0,0,0,0,107663
920,1400000US24033801210,51,1.1,0,51,0,1.9,76484
921,1400000US24033801211,131,4.3,23,108,1.6,6.7,93367
922,1400000US24033801212,97,2.9,50,47,3,2.7,89250
923,1400000US24033801213,207,5.9,97,110,6,5.8,77500
924,1400000US24033801214,196,5.1,25,171,1.4,8.2,70375
925,1400000US24033801215,32,1.3,8,24,0.7,1.8,104643
926,1400000US24033801217,80,2.6,16,64,1.1,3.9,97527
927,1400000US24033801302,45,1.6,22,23,1.4,1.8,97714
928,1400000US24033801305,49,0.8,7,42,0.3,1.3,92015
929,1400000US24033801307,53,1.5,10,43,0.6,2.2,132625
930,1400000US24033801309,80,2.5,46,34,2.9,2.1,120030
931,1400000US24033801310,33,0.5,33,0,1,0,126917
932,1400000US24033801311,309,5.7,204,105,8.1,3.6,107287
933,1400000US24033801312,527,14.5,206,321,11.1,18,95750
934,1400000US24033801404,281,6,101,180,4.2,8,81790
935,1400000US24033801405,299,6.1,88,211,4,7.7,62599
936,1400000US24033801406,764,24.3,152,612,12.1,32.3,56285
937,1400000US24033801407,304,5.1,17,287,0.6,9,81067
938,1400000US24033801408,122,3.7,94,28,7.7,1.3,64103
939,1400000US24033801410,66,1.7,17,49,0.9,2.7,106599
940,1400000US24033801411,80,2.3,30,50,1.8,2.7,82056
941,1400000US24033801500,90,4.1,28,62,2.7,5.4,73254
942,1400000US24033801600,263,9.8,79,184,5.9,13.7,50917
943,1400000US24033801701,374,9.9,173,201,10,9.8,72452
944,1400000US24033801704,653,11.5,373,280,13.9,9.4,51340
945,1400000US24033801706,166,10.2,70,96,10.1,10.2,62917
946,1400000US24033801707,803,12.9,281,522,10.3,15,54013
947,1400000US24033801708,147,4.2,69,78,4.3,4.1,57702
948,1400000US24033801802,182,4.8,60,122,3.3,6.1,53550
949,1400000US24033801804,281,14.2,172,109,16.7,11.5,70000
950,1400000US24033801807,520,10.9,198,322,8.7,12.8,62104
951,1400000US24033801808,263,7.3,99,164,5.5,9.1,54276
952,1400000US24033801901,247,5.2,120,127,5.2,5.3,81927
953,1400000US24033801904,217,6.3,45,172,2.5,10.3,63598
954,1400000US24033801905,157,3.3,130,27,5.8,1.1,90262
955,1400000US24033801906,213,9.6,97,116,8.5,10.9,68359
956,1400000US24033801907,355,9.7,144,211,8.5,10.7,60625
957,1400000US24033802001,186,3.3,114,72,4.5,2.4,50414
958,1400000US24033802002,114,3.3,43,71,2.8,3.6,68664
959,1400000US24033802103,26,1,19,7,1.6,0.5,79177
960,1400000US24033802106,545,12.5,327,218,16,9.5,43252
961,1400000US24033802107,365,8.4,217,148,10.6,6.5,50663
962,1400000US24033802201,142,8.2,22,120,3,11.9,50958
963,1400000US24033802204,221,3.9,106,115,4.5,3.4,76500
964,1400000US24033802301,152,3.8,78,74,4.2,3.5,69351
965,1400000US24033802404,850,18.8,338,512,19.3,18.5,47973
966,1400000US24033802405,290,8.1,144,146,8.9,7.4,52836
967,1400000US24033802407,654,15.1,313,341,16.9,13.8,54072
968,1400000US24033802408,364,22,167,197,19.5,24.6,39788
969,1400000US24033802501,253,7.5,105,148,6.2,8.8,52287
970,1400000US24033802502,214,7.9,184,30,12.3,2.5,70061
971,1400000US24033802700,169,7,61,108,5.5,8.3,51563
972,1400000US24033802803,624,12.5,358,266,16.2,9.5,62019
973,1400000US24033802804,331,6,155,176,6.2,5.7,63845
974,1400000US24033802805,824,17.1,345,479,15.5,18.4,52582
975,1400000US24033802901,786,19.4,409,377,20.9,18.1,48077
