OBJECTID,GEO.id,acs_bpl,acs_bplp,acs_bplm,acs_bplf,acs_bplmp,acs_bplfp
1,1400000US11001007407,942,31.7,427,515,28.7,34.6
2,1400000US11001007409,1261,34.2,442,819,29.4,37.5
3,1400000US11001007502,1434,37.8,617,817,38.7,37.1
4,1400000US11001007503,852,37.8,415,437,39.9,36.1
5,1400000US11001007504,1384,47.6,470,914,34.8,58.7
6,1400000US11001007603,552,12.5,185,367,9.7,14.6
7,1400000US11001007604,717,21.2,343,374,23.8,19.3
8,1400000US11001007605,970,28.5,420,550,26.4,30.2
9,1400000US11001007707,603,16.1,169,434,10.9,19.7
10,1400000US11001007708,922,32.0,384,538,28.0,35.6
11,1400000US11001007709,252,16.1,118,134,15.1,17.1
12,1400000US11001007803,728,25.9,317,411,23.4,28.1
13,1400000US11001007804,990,35.8,262,728,23.8,43.8
14,1400000US11001007807,566,27.9,203,363,26.3,28.9
15,1400000US11001007808,1451,39.2,436,1015,26.8,48.8
16,1400000US11001007809,950,35.0,412,538,34.8,35.2
17,1400000US11001007903,238,16.1,50,188,8.2,21.8
18,1400000US11001008001,291,11.7,12,279,1.2,19.2
19,1400000US11001008002,267,7.5,136,131,7.3,7.7
20,1400000US11001008200,361,13.0,155,206,12.5,13.4
21,1400000US11001008301,172,7.3,126,46,9.9,4.3
22,1400000US11001008402,478,19.7,28,450,2.9,31.2
23,1400000US11001008410,227,14.5,106,121,10.9,20.6
24,1400000US11001008701,160,8.3,24,136,2.8,12.5
25,1400000US11001008802,1202,27.4,486,716,23.7,30.7
26,1400000US11001008803,360,32.9,222,138,38.1,27.0
27,1400000US11001008804,1109,40.3,630,479,43.6,36.7
28,1400000US11001008903,665,29.4,327,338,28.4,30.5
29,1400000US11001009000,434,16.9,145,289,14.4,18.6
30,1400000US11001009102,1567,32.8,707,860,30.5,35.1
31,1400000US11001009201,240,19.4,83,157,14.7,23.4
32,1400000US11001009204,586,24.4,203,383,19.4,28.4
33,1400000US11001000100,334,7.0,126,208,5.3,8.6
34,1400000US11001000201,0,-,0,0,-,-
35,1400000US11001000400,63,4.9,49,14,7.5,2.2
36,1400000US11001000702,267,8.6,133,134,10.0,7.5
37,1400000US11001001002,531,15.9,151,380,11.3,19.0
38,1400000US11001001401,196,6.2,107,89,6.8,5.6
39,1400000US11001001702,243,9.9,109,134,9.9,9.8
40,1400000US11001002201,124,3.5,53,71,3.2,3.9
41,1400000US11001002501,652,28.4,326,326,25.5,32.0
42,1400000US11001002801,796,20.9,391,405,19.2,22.9
43,1400000US11001002900,700,18.0,399,301,19.1,16.7
44,1400000US11001003301,634,22.4,360,274,25.1,19.7
45,1400000US11001003600,829,19.5,396,433,19.4,19.7
46,1400000US11001004002,127,5.5,48,79,4.2,6.7
47,1400000US11001004202,114,4.8,38,76,3.4,6.1
48,1400000US11001004702,485,33.1,323,162,43.4,22.5
49,1400000US11001004901,451,24.3,163,288,17.8,30.8
50,1400000US11001005600,1245,26.2,445,800,19.9,31.9
51,1400000US11001006400,598,31.1,184,414,21.7,38.5
52,1400000US11001006801,327,17.9,177,150,21.7,14.9
53,1400000US11001007100,1518,45.4,532,986,38.7,50.1
54,1400000US11001007403,983,35.7,555,428,42.6,29.4
55,1400000US11001007408,1220,53.3,496,724,58.4,50.2
56,1400000US11001007601,759,19.4,328,431,18.4,20.1
57,1400000US11001007703,1473,26.3,525,948,22.9,28.7
58,1400000US11001007806,486,23.0,142,344,15.7,28.5
59,1400000US11001007901,1420,37.7,422,998,26.7,45.6
60,1400000US11001008302,57,2.8,21,36,2.2,3.4
61,1400000US11001008702,287,16.8,131,156,15.2,18.3
62,1400000US11001008904,846,25.8,426,420,27.0,24.7
63,1400000US11001009203,314,12.4,237,77,16.5,7.0
64,1400000US11001009302,53,4.4,53,0,8.5,0.0
65,1400000US11001009504,359,13.0,176,183,12.3,13.8
66,1400000US11001009509,151,5.5,33,118,2.7,7.8
67,1400000US11001009602,1239,41.8,450,789,39.3,43.3
68,1400000US11001009603,496,15.2,198,298,13.8,16.3
69,1400000US11001009604,402,20.1,92,310,14.3,22.8
70,1400000US11001009700,764,31.8,295,469,30.2,32.9
71,1400000US11001009802,533,45.6,232,301,49.5,43.0
72,1400000US11001009807,461,14.5,234,227,15.2,13.9
73,1400000US11001009904,385,23.8,77,308,10.0,36.3
74,1400000US11001009906,219,13.1,129,90,14.5,11.6
75,1400000US11001010500,822,19.4,424,398,18.2,20.9
76,1400000US11001010800,1011,64.7,425,586,60.6,68.1
77,1400000US11001000202,495,14.4,197,298,11.5,17.4
78,1400000US11001000300,681,12.0,323,358,11.3,12.7
79,1400000US11001000501,459,14.3,92,367,7.0,19.3
80,1400000US11001000502,234,7.2,88,146,6.2,8.0
81,1400000US11001000600,216,5.3,53,163,2.8,7.6
82,1400000US11001000701,69,1.5,0,69,0.0,2.6
83,1400000US11001000802,209,8.1,118,91,9.3,6.9
84,1400000US11001000901,183,4.9,101,82,5.5,4.3
85,1400000US11001000902,128,5.7,21,107,1.9,9.3
86,1400000US11001001001,543,7.7,318,225,9.6,6.0
87,1400000US11001001100,314,7.4,124,190,6.1,8.5
88,1400000US11001001200,485,9.7,159,326,7.3,11.6
89,1400000US11001001301,427,10.1,308,119,14.2,5.8
90,1400000US11001001302,451,6.4,154,297,5.1,7.5
91,1400000US11001001402,198,6.8,48,150,3.4,9.9
92,1400000US11001001500,169,3.0,88,81,3.2,2.8
93,1400000US11001001600,172,3.9,33,139,1.6,5.9
94,1400000US11001001803,424,14.3,177,247,12.9,15.5
95,1400000US11001001804,1276,26.5,540,736,23.1,29.8
96,1400000US11001001901,443,10.6,80,363,4.6,14.9
97,1400000US11001002001,188,7.0,119,69,9.4,4.9
98,1400000US11001002002,412,11.5,185,227,12.1,11.0
99,1400000US11001002101,806,17.0,417,389,18.1,16.0
100,1400000US11001002102,526,12.2,149,377,8.9,14.3
101,1400000US11001002202,315,10.8,170,145,13.4,8.8
102,1400000US11001002301,367,12.3,165,202,10.3,14.6
103,1400000US11001002302,401,30.9,222,179,29.9,32.2
104,1400000US11001002400,478,12.7,286,192,14.4,10.8
105,1400000US11001002502,532,11.0,332,200,14.3,8.0
106,1400000US11001002600,137,6.0,83,54,8.0,4.3
107,1400000US11001002701,654,12.5,299,355,10.7,14.7
108,1400000US11001002702,387,7.6,115,272,4.5,10.6
109,1400000US11001002802,860,21.6,385,475,19.3,24.0
110,1400000US11001003000,701,23.1,361,340,26.1,20.7
111,1400000US11001003100,224,7.8,113,111,6.8,9.1
112,1400000US11001003200,918,20.5,287,631,14.1,25.9
113,1400000US11001003302,416,18.9,179,237,15.7,22.4
114,1400000US11001003400,900,34.0,357,543,26.2,42.2
115,1400000US11001003500,744,31.9,407,337,30.1,34.3
116,1400000US11001003700,1111,26.2,624,487,31.2,21.7
117,1400000US11001003800,240,5.9,194,46,8.1,2.8
118,1400000US11001003900,230,5.1,153,77,7.0,3.4
119,1400000US11001004001,120,3.7,74,46,4.5,2.9
120,1400000US11001004100,114,4.2,46,68,3.6,4.8
121,1400000US11001004201,694,19.6,394,300,19.3,20.0
122,1400000US11001004300,552,19.3,295,257,21.1,17.6
123,1400000US11001004400,550,12.3,316,234,13.7,10.7
124,1400000US11001004600,454,19.1,150,304,14.2,22.9
125,1400000US11001004701,1884,49.0,720,1164,45.0,51.9
126,1400000US11001004801,252,14.4,101,151,12.1,16.5
127,1400000US11001004802,418,13.7,161,257,11.5,15.5
128,1400000US11001004902,453,17.3,229,224,15.8,19.1
129,1400000US11001005001,163,10.3,163,0,15.1,0.0
130,1400000US11001005002,689,11.8,462,227,13.9,9.1
131,1400000US11001005201,619,11.9,329,290,10.7,13.6
132,1400000US11001005301,1000,16.7,513,487,16.6,16.8
133,1400000US11001005500,758,12.8,414,344,13.6,11.9
134,1400000US11001005800,150,5.6,44,106,3.4,7.7
135,1400000US11001005900,1570,44.4,1086,484,51.4,34.0
136,1400000US11001006202,0,-,0,0,-,-
137,1400000US11001006500,33,1.3,11,22,1.0,1.5
138,1400000US11001006600,162,8.7,54,108,6.5,10.5
139,1400000US11001006700,184,4.6,128,56,6.6,2.7
140,1400000US11001006802,56,2.7,27,29,2.9,2.5
141,1400000US11001006804,31,91.2,24,7,88.9,100.0
142,1400000US11001006900,202,9.1,53,149,4.9,13.0
143,1400000US11001007000,208,10.7,58,150,7.1,13.3
144,1400000US11001007200,141,11.7,67,74,12.1,11.4
145,1400000US11001007301,35,1.4,25,10,1.9,0.9
146,1400000US11001007304,1298,38.2,450,848,30.3,44.3
147,1400000US11001007401,1255,57.3,445,810,47.3,64.7
148,1400000US11001007404,1616,48.8,667,949,47.4,49.8
149,1400000US11001007406,1495,47.2,601,894,45.7,48.3
150,1400000US11001009301,810,23.2,253,557,15.7,29.7
151,1400000US11001009400,344,8.7,177,167,10.0,7.6
152,1400000US11001009501,796,19.7,471,325,22.8,16.5
153,1400000US11001009503,244,8.8,102,142,8.0,9.5
154,1400000US11001009505,167,6.2,58,109,5.3,6.9
155,1400000US11001009507,83,4.4,41,42,4.9,4.0
156,1400000US11001009508,271,9.0,123,148,9.2,8.8
157,1400000US11001009601,1336,45.6,538,798,56.3,40.5
158,1400000US11001009801,606,39.6,250,356,33.7,45.2
159,1400000US11001009803,567,24.3,206,361,21.6,26.2
160,1400000US11001009804,702,24.5,320,382,26.1,23.4
161,1400000US11001009810,813,34.9,343,470,33.2,36.3
162,1400000US11001009811,1631,46.2,494,1137,39.9,49.6
163,1400000US11001009901,121,6.0,25,96,2.8,8.5
164,1400000US11001009902,650,23.4,275,375,24.6,22.6
165,1400000US11001009903,337,24.3,148,189,21.6,27.0
166,1400000US11001009905,483,18.1,209,274,17.0,19.0
167,1400000US11001009907,1053,40.7,303,750,33.3,44.7
168,1400000US11001010100,296,14.0,117,179,11.3,16.5
169,1400000US11001010200,281,10.6,110,171,10.4,10.7
170,1400000US11001010300,133,4.9,30,103,2.2,7.6
171,1400000US11001010400,1354,34.3,785,569,37.2,31.0
172,1400000US11001010600,589,16.2,341,248,16.7,15.5
173,1400000US11001010700,494,28.6,179,315,26.2,30.2
174,1400000US11001010900,1480,48.4,426,1054,35.1,57.3
175,1400000US11001011000,708,17.4,294,414,17.1,17.7
176,1400000US11001011100,444,11.1,197,247,10.6,11.6
177,1400000US11001001902,165,7.8,83,82,8.7,7.0
178,1400000US11001008100,222,6.6,49,173,3.0,10.0
179,1400000US11001000801,403,7.0,204,199,8.0,6.1
180,1400000US51059415100,233,6.8,91,142,5.6,7.9
181,1400000US51059415401,314,6.8,189,125,9.0,4.9
182,1400000US51059416000,775,14.9,260,515,10.8,18.3
183,1400000US51059420100,599,14.7,383,216,18.0,11.1
184,1400000US51059420800,330,9.0,187,143,9.5,8.5
185,1400000US51059421200,0,0.0,0,0,0.0,0.0
186,1400000US51059421600,853,14.6,274,579,9.8,19.1
187,1400000US51059421800,495,9.3,255,240,10.4,8.4
188,1400000US51059422301,26,0.9,0,26,0.0,1.9
189,1400000US51059422401,178,9.1,13,165,1.5,15.6
190,1400000US51059430203,246,8.9,66,180,5.0,12.4
191,1400000US51059430500,64,3.8,32,32,4.2,3.5
192,1400000US51059430901,164,3.7,74,90,3.7,3.8
193,1400000US51059431801,102,2.5,0,102,0.0,4.8
194,1400000US51059431900,0,0.0,0,0,0.0,0.0
195,1400000US51059432300,185,3.5,89,96,3.4,3.6
196,1400000US51059432702,115,2.7,63,52,2.8,2.7
197,1400000US51059440600,124,4.0,75,49,5.1,3.0
198,1400000US51059450200,551,14.1,291,260,14.9,13.3
199,1400000US51059450500,333,12.3,169,164,12.3,12.3
200,1400000US51059450702,606,15.3,269,337,12.8,18.1
201,1400000US51059451300,0,0.0,0,0,0.0,0.0
202,1400000US51059451900,288,4.9,80,208,3.0,6.6
203,1400000US51059452102,366,13.6,137,229,10.8,16.1
204,1400000US51059452502,1208,24.9,624,584,25.5,24.3
205,1400000US51059452802,441,15.3,170,271,13.0,17.2
206,1400000US51059460200,87,2.2,26,61,1.4,2.9
207,1400000US51059460300,39,1.4,9,30,0.6,2.2
208,1400000US51059460600,24,0.6,0,24,0.0,1.3
209,1400000US51059461000,43,2.0,7,36,0.7,3.1
210,1400000US51059461601,144,2.4,107,37,3.5,1.3
211,1400000US51059461901,428,11.5,189,239,10.3,12.6
212,1400000US51059470600,163,5.7,15,148,1.1,9.8
213,1400000US51059471000,31,1.6,31,0,3.4,0.0
214,1400000US51059471303,139,3.8,38,101,2.3,5.1
215,1400000US51059480202,17,0.8,3,14,0.3,1.3
216,1400000US51059480501,0,0.0,0,0,0.0,0.0
217,1400000US51059480802,110,2.7,41,69,1.9,3.6
218,1400000US51059481000,72,1.8,12,60,0.6,3.3
219,1400000US51059481104,37,1.4,6,31,0.5,2.5
220,1400000US51059481701,32,0.5,10,22,0.3,0.7
221,1400000US51059482301,61,1.5,29,32,1.4,1.6
222,1400000US51059482502,0,0.0,0,0,0.0,0.0
223,1400000US51059490501,116,3.7,103,13,6.0,0.9
224,1400000US51059491202,285,19.8,134,151,15.6,26.0
225,1400000US51059491401,439,9.8,164,275,8.0,11.2
226,1400000US51059491501,349,5.5,127,222,4.4,6.4
227,1400000US51059491703,291,6.8,138,153,6.0,7.7
228,1400000US51059491801,169,6.9,113,56,8.0,5.4
229,1400000US51059492202,106,1.6,75,31,2.3,0.9
230,1400000US51059980100,0,-,0,0,-,-
231,1400000US51013100100,39,0.9,21,18,0.9,0.9
232,1400000US51013100400,8,0.2,0,8,0.0,0.5
233,1400000US51013100800,62,4.3,40,22,5.3,3.2
234,1400000US51013101401,66,5.3,18,48,2.9,7.6
235,1400000US51013101602,76,5.4,11,65,1.8,8.2
236,1400000US51013101703,323,13.1,116,207,8.6,18.6
237,1400000US51013101900,10,0.4,2,8,0.2,0.5
238,1400000US51013102301,24,1.8,15,9,2.4,1.3
239,1400000US51013102702,247,17.5,136,111,16.6,18.6
240,1400000US51013102902,256,6.3,130,126,6.9,5.8
241,1400000US51013103402,196,5.1,104,92,5.8,4.5
242,1400000US51013103602,119,10.9,28,91,6.8,13.4
243,1400000US51510200103,801,10.9,292,509,8.5,12.9
244,1400000US51510200107,341,6.7,239,102,10.3,3.7
245,1400000US51510200301,252,9.2,60,192,4.7,13.1
246,1400000US51510200405,755,11.3,309,446,10.6,11.9
247,1400000US51510200500,522,12.4,252,270,12.5,12.3
248,1400000US51510200600,403,8.7,157,246,7.2,10.2
249,1400000US51510200701,0,0.0,0,0,0.0,0.0
250,1400000US51510200702,68,2.5,32,36,2.4,2.7
251,1400000US51510200900,60,1.2,37,23,1.6,0.9
252,1400000US51510201204,96,3.6,27,69,1.8,5.6
253,1400000US51510201600,774,16.7,203,571,9.5,22.8
254,1400000US51510202001,103,5.3,35,68,3.7,6.8
255,,,,,,,
256,1400000US51610500300,28,0.8,5,23,0.3,1.3
257,1400000US51059415200,121,3.9,21,100,1.6,5.7
258,1400000US51059415300,158,3.9,96,62,5.3,2.8
259,1400000US51059415402,126,4.9,39,87,3.2,6.5
260,1400000US51059415500,481,8.5,110,371,4.1,12.4
261,1400000US51059415600,0,0.0,0,0,0.0,0.0
262,1400000US51059415700,0,0.0,0,0,0.0,0.0
263,1400000US51059415800,73,1.6,0,73,0.0,3.3
264,1400000US51059415900,0,0.0,0,0,0.0,0.0
265,1400000US51059416100,131,3.7,68,63,4.0,3.5
266,1400000US51059416200,92,2.1,54,38,2.4,1.8
267,1400000US51059416300,61,2.7,29,32,2.5,3.0
268,1400000US51059420201,55,1.5,14,41,0.8,2.1
269,1400000US51059420202,5,0.3,5,0,0.5,0.0
270,1400000US51059420203,105,4.1,68,37,4.9,3.2
271,1400000US51059420300,120,2.0,90,30,2.7,1.1
272,1400000US51059420501,102,7.4,14,88,2.1,12.3
273,1400000US51059420502,134,9.8,70,64,8.9,11.1
274,1400000US51059420503,265,9.5,160,105,9.2,9.9
275,1400000US51059420600,205,4.9,89,116,3.8,6.1
276,1400000US51059420700,33,0.8,14,19,0.7,1.0
277,1400000US51059421001,33,1.1,7,26,0.5,1.8
278,1400000US51059421002,244,4.9,75,169,2.9,7.2
279,1400000US51059421101,30,0.5,12,18,0.4,0.6
280,1400000US51059421102,144,4.1,57,87,3.7,4.4
281,1400000US51059421103,79,1.5,29,50,1.2,1.7
282,1400000US51059421300,82,2.2,50,32,2.6,1.8
283,1400000US51059421400,936,16.1,368,568,13.7,18.1
284,1400000US51059421500,1152,17.4,416,736,12.5,22.3
285,1400000US51059421701,613,15.0,311,302,14.1,16.1
286,1400000US51059421702,186,4.3,113,73,5.0,3.6
287,1400000US51059421900,160,7.3,83,77,6.7,7.9
288,1400000US51059422000,144,3.9,52,92,2.9,4.9
289,1400000US51059422101,309,4.6,73,236,2.0,7.4
290,1400000US51059422102,224,3.8,143,81,5.3,2.5
291,1400000US51059422201,59,1.9,30,29,1.9,1.9
292,1400000US51059422202,148,2.8,22,126,0.8,4.6
293,1400000US51059422302,256,4.6,48,208,2.0,6.8
294,1400000US51059422402,166,3.3,42,124,1.6,5.2
295,1400000US51059422403,17,0.7,17,0,1.3,0.0
296,1400000US51059430101,82,1.8,44,38,2.0,1.6
297,1400000US51059430102,122,4.5,48,74,4.2,4.7
298,1400000US51059430201,186,4.1,86,100,4.0,4.1
299,1400000US51059430202,543,10.0,341,202,12.7,7.4
300,1400000US51059430400,136,1.9,56,80,1.5,2.3
301,1400000US51059430600,1292,17.1,616,676,16.0,18.3
302,1400000US51059430700,64,2.3,0,64,0.0,4.8
303,1400000US51059430801,160,3.8,66,94,3.2,4.4
304,1400000US51059430802,0,0.0,0,0,0.0,0.0
305,1400000US51059430902,83,2.5,58,25,3.2,1.6
306,1400000US51059431001,55,1.2,55,0,2.3,0.0
307,1400000US51059431002,110,5.3,0,110,0.0,9.7
308,1400000US51059431300,0,0.0,0,0,0.0,0.0
309,1400000US51059431400,189,4.0,87,102,3.9,4.1
310,1400000US51059431500,321,6.1,100,221,3.9,8.1
311,1400000US51059431600,395,4.9,212,183,5.7,4.3
312,1400000US51059431802,69,2.0,69,0,4.3,0.0
313,1400000US51059432000,210,6.4,101,109,6.3,6.5
314,1400000US51059432100,307,8.6,118,189,7.2,9.7
315,1400000US51059432201,75,4.1,39,36,4.4,3.8
316,1400000US51059432202,197,4.3,37,160,1.6,6.9
317,1400000US51059432401,11,0.3,11,0,0.6,0.0
318,1400000US51059432402,58,1.2,41,17,1.8,0.6
319,1400000US51059432500,28,0.5,13,15,0.4,0.5
320,1400000US51059432600,188,3.7,51,137,2.0,5.3
321,1400000US51059432701,77,2.4,38,39,2.4,2.5
322,1400000US51059432800,421,18.7,127,294,12.2,24.4
323,1400000US51059440100,385,5.2,236,149,6.4,3.9
324,1400000US51059440201,157,8.0,70,87,6.9,9.1
325,1400000US51059440202,90,1.5,62,28,2.2,0.9
326,1400000US51059440300,15,0.5,15,0,1.1,0.0
327,1400000US51059440501,246,4.8,150,96,6.1,3.6
328,1400000US51059440502,187,9.3,86,101,8.2,10.5
329,1400000US51059440701,34,1.2,34,0,2.5,0.0
330,1400000US51059440702,23,0.4,0,23,0.0,0.9
331,1400000US51059440800,271,4.4,140,131,4.9,4.0
332,1400000US51059450100,132,2.6,33,99,1.4,3.6
333,1400000US51059450300,336,6.8,236,100,9.8,3.9
334,1400000US51059450400,35,1.3,9,26,0.7,1.9
335,1400000US51059450601,49,1.4,0,49,0.0,2.8
336,1400000US51059450602,545,13.2,114,431,6.8,17.7
337,1400000US51059450701,88,3.0,88,0,5.6,0.0
338,1400000US51059450800,33,1.0,20,13,1.3,0.7
339,1400000US51059450900,126,7.2,64,62,7.7,6.8
340,1400000US51059451000,89,3.7,49,40,3.9,3.4
341,1400000US51059451100,49,2.3,29,20,2.8,1.8
342,1400000US51059451200,0,0.0,0,0,0.0,0.0
343,1400000US51059451400,753,27.8,388,365,28.4,27.2
344,1400000US51059451501,834,14.9,502,332,15.3,14.4
345,1400000US51059451502,141,3.4,30,111,1.5,5.3
346,1400000US51059451601,921,18.2,662,259,18.6,17.1
347,1400000US51059451602,22,0.9,0,22,0.0,1.5
348,1400000US51059451800,247,7.5,144,103,8.5,6.4
349,1400000US51059452000,299,11.0,136,163,10.1,11.8
350,1400000US51059452101,266,5.5,31,235,1.6,8.1
351,1400000US51059452200,72,1.2,28,44,0.9,1.6
352,1400000US51059452301,851,24.6,525,326,30.0,19.0
353,1400000US51059452302,158,3.4,58,100,2.7,4.0
354,1400000US51059452400,286,4.2,55,231,1.7,6.4
355,1400000US51059452501,314,8.0,58,256,3.1,12.7
356,1400000US51059452600,255,5.6,83,172,3.9,7.2
357,1400000US51059452700,696,13.5,358,338,14.7,12.4
358,1400000US51059452801,564,13.7,208,356,9.5,18.5
359,1400000US51059460100,54,1.2,22,32,1.0,1.4
360,1400000US51059460400,273,5.6,35,238,1.6,8.9
361,1400000US51059460501,102,4.1,25,77,2.1,6.0
362,1400000US51059460502,129,1.9,12,117,0.4,3.3
363,1400000US51059460701,383,11.4,160,223,9.6,13.3
364,1400000US51059460702,221,5.1,107,114,4.8,5.3
365,1400000US51059460800,116,3.7,51,65,3.0,4.5
366,1400000US51059460900,8,0.3,0,8,0.0,0.7
367,1400000US51059461100,388,5.3,121,267,3.0,7.9
368,1400000US51059461201,35,0.8,0,35,0.0,1.5
369,1400000US51059461202,569,12.7,114,455,5.8,18.0
370,1400000US51059461500,217,3.4,121,96,3.5,3.2
371,1400000US51059461602,249,6.4,56,193,2.8,10.3
372,1400000US51059461700,215,3.5,79,136,2.5,4.4
373,1400000US51059461801,91,8.4,30,61,6.3,10.1
374,1400000US51059461802,277,6.2,157,120,8.1,4.7
375,1400000US51059461902,193,10.5,108,85,9.8,11.6
376,1400000US51059470100,34,1.2,0,34,0.0,2.3
377,1400000US51059470300,33,1.0,0,33,0.0,2.0
378,1400000US51059470400,45,1.0,11,34,0.5,1.6
379,1400000US51059470500,202,4.1,78,124,3.1,5.1
380,1400000US51059470700,214,4.3,65,149,2.8,5.5
381,1400000US51059470800,34,1.2,9,25,0.7,1.7
382,1400000US51059470900,256,3.6,117,139,3.5,3.6
383,1400000US51059471100,344,5.4,151,193,4.8,5.9
384,1400000US51059471201,111,4.2,12,99,1.0,7.1
385,1400000US51059471202,105,2.6,73,32,3.7,1.6
386,1400000US51059471301,152,4.9,0,152,0.0,9.8
387,1400000US51059471304,0,0.0,0,0,0.0,0.0
388,1400000US51059471401,233,7.0,72,161,5.2,8.4
389,1400000US51059471402,404,11.9,155,249,9.9,13.5
390,1400000US51059480100,17,0.4,7,10,0.3,0.5
391,1400000US51059480201,108,2.7,34,74,1.6,3.8
392,1400000US51059480203,94,4.6,0,94,0.0,8.0
393,1400000US51059480300,126,1.7,61,65,1.6,1.9
394,1400000US51059480401,105,2.3,42,63,1.9,2.7
395,1400000US51059480402,119,1.8,35,84,1.1,2.5
396,1400000US51059480502,365,5.9,134,231,4.6,7.1
397,1400000US51059480503,88,2.4,27,61,1.4,3.4
398,1400000US51059480504,40,2.2,14,26,1.8,2.4
399,1400000US51059480505,43,1.5,31,12,2.1,0.8
400,1400000US51059480801,33,0.8,13,20,0.6,1.0
401,1400000US51059480901,413,6.1,226,187,6.9,5.4
402,1400000US51059480902,220,5.7,76,144,3.5,8.7
403,1400000US51059480903,72,1.9,35,37,1.9,1.8
404,1400000US51059481101,30,1.8,0,30,0.0,3.9
405,1400000US51059481102,147,5.8,59,88,4.7,6.8
406,1400000US51059481103,153,4.7,65,88,3.8,5.6
407,1400000US51059481105,37,0.7,25,12,1.0,0.4
408,1400000US51059481106,26,0.5,0,26,0.0,0.9
409,1400000US51059481201,0,0.0,0,0,0.0,0.0
410,1400000US51059481202,845,14.4,329,516,11.0,18.0
411,1400000US51059481400,547,9.3,132,415,4.9,13.1
412,1400000US51059481500,0,0.0,0,0,0.0,0.0
413,1400000US51059481600,78,2.3,8,70,0.5,4.0
414,1400000US51059481702,263,7.1,157,106,8.6,5.6
415,1400000US51059481900,435,8.1,183,252,7.0,9.3
416,1400000US51059482001,48,1.0,15,33,0.6,1.4
417,1400000US51059482100,147,5.5,100,47,7.4,3.6
418,1400000US51059482201,152,7.5,50,102,5.7,8.8
419,1400000US51059482202,161,5.2,48,113,3.3,7.0
420,1400000US51059482203,9,0.3,9,0,0.6,0.0
421,1400000US51059482302,988,24.4,569,419,25.7,22.8
422,1400000US51059482303,104,3.5,44,60,3.2,3.7
423,1400000US51059482400,18,0.8,11,7,1.1,0.6
424,1400000US51059482501,174,3.0,71,103,2.6,3.3
425,1400000US51059482503,71,1.5,15,56,0.6,2.3
426,1400000US51059482504,0,0.0,0,0,0.0,0.0
427,1400000US51059482601,80,1.1,28,52,0.8,1.5
428,1400000US51059482602,189,2.8,75,114,2.4,3.2
429,1400000US51059490101,280,5.3,108,172,4.5,6.1
430,1400000US51059490103,153,2.9,100,53,3.5,2.1
431,1400000US51059490502,328,5.4,109,219,3.7,7.0
432,1400000US51059491000,21,1.1,14,7,1.6,0.7
433,1400000US51059491101,11,0.3,0,11,0.0,0.6
434,1400000US51059491102,0,0.0,0,0,0.0,0.0
435,1400000US51059491201,140,2.4,43,97,1.5,3.3
436,1400000US51059491301,132,1.9,50,82,1.5,2.3
437,1400000US51059491302,237,6.4,149,88,8.8,4.4
438,1400000US51059491303,284,7.5,190,94,9.3,5.5
439,1400000US51059491402,306,7.2,176,130,8.1,6.3
440,1400000US51059491403,79,2.0,31,48,1.5,2.4
441,1400000US51059491404,158,4.0,39,119,2.0,5.9
442,1400000US51059491405,0,0.0,0,0,0.0,0.0
443,1400000US51059491502,44,0.6,22,22,0.6,0.6
444,1400000US51059491601,617,12.7,248,369,11.7,13.6
445,1400000US51059491602,414,7.6,213,201,7.7,7.5
446,1400000US51059491701,83,2.7,12,71,0.8,4.2
447,1400000US51059491702,490,7.5,208,282,6.9,8.1
448,1400000US51059491704,324,8.1,78,246,4.1,11.7
449,1400000US51059491705,445,12.0,174,271,10.4,13.4
450,1400000US51059491802,40,1.6,30,10,2.5,0.7
451,1400000US51059491803,342,5.3,135,207,4.2,6.4
452,1400000US51059492000,136,2.1,89,47,2.7,1.4
453,1400000US51059492100,311,4.7,174,137,5.3,4.1
454,1400000US51059492201,96,3.7,15,81,1.3,5.8
455,1400000US51059492203,0,0.0,0,0,0.0,0.0
456,1400000US51059492300,184,5.4,96,88,5.5,5.3
457,1400000US51059492400,251,5.2,149,102,6.1,4.4
458,1400000US51059492500,166,3.9,111,55,5.3,2.5
459,1400000US51059980200,0,-,0,0,-,-
460,1400000US51059980300,0,-,0,0,-,-
461,1400000US51013100200,103,1.7,0,103,0.0,3.4
462,1400000US51013100300,67,1.2,20,47,0.8,1.7
463,1400000US51013100500,193,4.3,89,104,3.9,4.7
464,1400000US51013100600,131,4.7,41,90,3.2,6.1
465,1400000US51013100700,103,2.2,32,71,1.5,2.6
466,1400000US51013100900,195,4.8,108,87,6.1,3.8
467,1400000US51013101000,127,4.0,63,64,4.3,3.8
468,1400000US51013101100,85,1.6,38,47,1.5,1.7
469,1400000US51013101200,162,4.8,45,117,2.9,6.4
470,1400000US51013101300,102,1.7,37,65,1.1,2.4
471,1400000US51013101402,117,4.6,0,117,0.0,9.2
472,1400000US51013101403,228,4.5,89,139,3.4,5.8
473,1400000US51013101404,144,4.2,87,57,5.3,3.2
474,1400000US51013101500,493,6.6,251,242,7.3,6.1
475,1400000US51013101601,127,8.4,78,49,10.3,6.5
476,1400000US51013101603,237,7.7,138,99,7.9,7.3
477,1400000US51013101701,306,10.7,79,227,5.8,15.0
478,1400000US51013101702,694,17.5,363,331,20.3,15.2
479,1400000US51013101801,43,2.1,0,43,0.0,4.6
480,1400000US51013101802,247,4.5,120,127,4.0,5.1
481,1400000US51013101803,224,5.2,129,95,5.7,4.7
482,1400000US51013102001,144,9.1,47,97,5.7,12.7
483,1400000US51013102002,212,14.3,117,95,14.9,13.6
484,1400000US51013102003,446,12.0,232,214,11.5,12.7
485,1400000US51013102100,380,16.0,53,327,5.5,23.1
486,1400000US51013102200,1663,24.7,660,1003,19.3,30.4
487,1400000US51013102302,522,11.8,250,272,10.5,13.2
488,1400000US51013102400,235,6.7,91,144,5.1,8.4
489,1400000US51013102500,146,3.1,95,51,4.0,2.2
490,1400000US51013102600,95,2.8,67,28,4.7,1.5
491,1400000US51013102701,650,18.0,330,320,16.7,19.7
492,1400000US51013102801,242,4.2,104,138,3.4,5.2
493,1400000US51013102802,55,4.6,4,51,0.7,8.5
494,1400000US51013102901,68,2.7,56,12,5.0,0.8
495,1400000US51013103000,159,4.8,38,121,2.7,6.3
496,1400000US51013103100,489,10.6,127,362,5.9,14.7
497,1400000US51013103200,506,10.0,209,297,8.2,11.8
498,1400000US51013103300,523,22.6,346,177,29.0,15.8
499,1400000US51013103401,0,0.0,0,0,0.0,0.0
500,1400000US51013103501,240,7.6,84,156,6.6,8.3
501,1400000US51013103502,560,21.6,134,426,11.2,30.6
502,1400000US51013103503,182,5.1,26,156,1.3,9.4
503,1400000US51013103601,29,1.3,18,11,1.6,0.9
504,1400000US51013103700,80,3.5,46,34,3.9,3.1
505,1400000US51013103800,376,8.7,195,181,8.6,8.9
506,1400000US51013980100,0,-,0,0,-,-
507,1400000US51013980200,0,0.0,0,0,0.0,-
508,1400000US51059491103,730,10.7,381,349,10.5,11.1
509,1400000US51510201300,264,8.1,129,135,7.8,8.4
510,1400000US51510201400,260,6.2,156,104,7.7,4.8
511,1400000US51510201500,85,2.7,60,25,4.1,1.5
512,1400000US51510201801,306,6.3,144,162,5.9,6.6
513,1400000US51510201802,261,13.8,77,184,9.4,17.1
514,1400000US51510201900,31,2.0,8,23,1.0,2.9
515,1400000US51510202002,140,6.0,45,95,4.3,7.3
516,1400000US51510200102,264,6.5,115,149,5.1,8.2
517,1400000US51510200104,546,15.3,222,324,13.0,17.5
518,1400000US51510200105,458,11.7,274,184,12.3,10.9
519,1400000US51510200106,98,3.8,12,86,1.1,5.8
520,1400000US51510200201,217,6.9,32,185,2.1,11.8
521,1400000US51510200202,39,2.6,0,39,0.0,4.5
522,1400000US51510200302,202,4.9,88,114,5.0,4.9
523,1400000US51510200303,380,8.5,119,261,5.8,10.7
524,1400000US51510200403,14,1.1,14,0,1.9,0.0
525,1400000US51510200404,25,0.7,0,25,0.0,1.3
526,1400000US51510200406,533,12.1,231,302,10.7,13.5
527,1400000US51510200407,166,4.2,55,111,3.2,5.0
528,1400000US51510200703,389,15.4,171,218,12.7,18.5
529,1400000US51510200801,60,2.2,10,50,0.7,3.7
530,1400000US51510200802,211,7.3,103,108,6.8,7.9
531,1400000US51510201000,100,3.9,25,75,2.3,5.0
532,1400000US51510201100,54,1.9,28,26,2.1,1.6
533,1400000US51510201202,62,1.9,20,42,1.1,2.9
534,1400000US51510201203,955,17.7,454,501,15.7,20.0
535,,,,,,,
536,,,,,,,
537,,,,,,,
538,,,,,,,
539,1400000US51610500100,61,2.4,28,33,2.1,2.8
540,1400000US51610500200,457,8.4,106,351,4.4,11.5
541,1400000US51059420400,117,5.4,64,53,5.8,5.0
542,1400000US51059482002,55,1.7,0,55,0.0,3.4
543,1400000US24031700105,111,1.6,13,98,0.4,2.8
544,1400000US24031700304,581,8.2,288,293,8.1,8.3
545,1400000US24031700607,216,2.6,121,95,2.9,2.2
546,1400000US24031700611,12,0.2,0,12,0.0,0.4
547,1400000US24031700710,345,5.3,183,162,5.3,5.3
548,1400000US24031700718,80,2.0,0,80,0.0,4.0
549,1400000US24031700723,355,12.8,141,214,11.9,13.4
550,1400000US24031700815,577,7.3,414,163,10.5,4.1
551,1400000US24031700820,405,14.7,144,261,10.0,20.0
552,1400000US24031700824,102,3.8,66,36,4.9,2.7
553,1400000US24033803001,202,7.0,84,118,6.4,7.6
554,1400000US24033803002,235,8.4,73,162,5.7,10.7
555,1400000US24033803100,355,15.6,217,138,20.8,11.1
556,1400000US24033803200,473,16.2,280,193,18.7,13.6
557,1400000US24033803512,141,2.2,81,60,3.0,1.7
558,1400000US24033803519,197,5.8,39,158,2.8,7.8
559,1400000US24033803525,369,13.1,169,200,12.8,13.3
560,1400000US24033803613,198,4.6,146,52,6.7,2.5
561,1400000US24033804001,627,13.0,244,383,10.6,15.2
562,1400000US24033804400,312,12.7,125,187,11.1,14.0
563,1400000US24033804900,705,21.3,161,544,13.8,25.3
564,1400000US24033805601,1624,26.8,989,635,22.9,36.6
565,1400000US24033805904,613,19.3,398,215,24.3,14.0
566,1400000US24033806200,120,2.9,12,108,0.6,5.1
567,1400000US24033806602,539,12.1,240,299,11.2,12.8
568,1400000US24033806712,61,2.1,14,47,1.0,3.2
569,1400000US24033807304,108,5.3,64,44,5.4,5.1
570,1400000US24031700826,200,3.4,17,183,0.7,5.4
571,1400000US24031700828,42,1.6,0,42,0.0,2.7
572,1400000US24031700829,32,1.1,15,17,1.2,1.1
573,1400000US24031700830,52,2.9,16,36,2.1,3.5
574,1400000US24031700901,365,10.7,133,232,9.2,11.7
575,1400000US24031701002,13,0.4,0,13,0.0,0.7
576,1400000US24031701102,295,5.2,80,215,2.8,7.9
577,1400000US24031701210,52,1.3,22,30,1.1,1.4
578,1400000US24031701215,211,5.2,37,174,2.2,7.5
579,1400000US24031701304,80,1.3,38,42,1.3,1.2
580,1400000US24031701313,123,3.2,0,123,0.0,6.7
581,1400000US24031701409,82,1.8,41,41,2.0,1.7
582,1400000US24031701422,528,26.8,212,316,23.0,30.2
583,1400000US24031701508,145,3.8,51,94,3.5,4.0
584,1400000US24031701601,56,2.4,11,45,1.0,3.6
585,1400000US24031701900,382,12.3,122,260,6.9,19.5
586,1400000US24031702102,43,1.5,35,8,2.6,0.5
587,1400000US24031702500,338,8.1,132,206,6.6,9.5
588,1400000US24031703201,511,6.9,280,231,7.7,6.2
589,1400000US24031703209,1258,23.2,517,741,22.4,23.8
590,1400000US24031703218,43,2.4,14,29,2.3,2.5
591,1400000US24031703301,278,6.4,133,145,6.0,6.7
592,1400000US24031703402,210,6.1,109,101,6.2,6.1
593,1400000US24031703602,90,3.3,0,90,0.0,6.2
594,1400000US24031703902,1043,15.6,339,704,10.0,21.3
595,1400000US24031704403,27,1.8,27,0,4.6,0.0
596,1400000US24031704804,24,2.1,9,15,1.9,2.3
597,1400000US24031705300,50,2.6,16,34,1.7,3.4
598,1400000US24031705601,43,1.6,17,26,1.4,1.7
599,1400000US24031705602,299,6.8,96,203,5.2,8.1
600,1400000US24031705701,184,4.3,83,101,4.4,4.3
601,1400000US24031705901,44,1.1,0,44,0.0,2.0
602,1400000US24031706011,151,2.9,48,103,1.9,3.9
603,1400000US24033800106,63,2.3,24,39,1.9,2.7
604,1400000US24033800209,352,9.5,194,158,10.1,8.8
605,1400000US24033800214,165,6.2,51,114,4.0,8.2
606,1400000US24033800408,194,3.0,105,89,3.1,2.8
607,1400000US24033800413,297,8.2,111,186,6.3,9.8
608,1400000US24033800514,119,2.9,119,0,5.6,0.0
609,1400000US24033800519,100,2.3,10,90,0.5,4.2
610,1400000US24033800704,114,2.4,30,84,1.6,2.9
611,1400000US24033801005,36,0.8,0,36,0.0,1.5
612,1400000US24033801006,112,2.9,72,40,3.8,2.0
613,1400000US24033801209,285,6.3,68,217,3.6,8.2
614,1400000US24033801216,159,4.7,79,80,4.3,5.0
615,1400000US24033801308,84,2.0,41,43,2.0,2.1
616,1400000US24033801313,12,0.4,0,12,0.0,0.7
617,1400000US24033801409,29,1.1,7,22,0.6,1.6
618,1400000US24033801702,683,18.4,350,333,21.1,16.3
619,1400000US24033801801,183,8.9,95,88,11.9,6.9
620,1400000US24033801805,32,1.4,7,25,0.6,2.3
621,1400000US24033802104,40,2.0,29,11,3.2,1.0
622,1400000US24033802203,219,4.7,92,127,4.2,5.1
623,1400000US24033802406,207,9.9,77,130,8.0,11.6
624,1400000US24033802600,145,4.9,20,125,1.3,8.6
625,1400000US24031700308,287,4.6,115,172,3.8,5.2
626,1400000US24031700309,705,13.6,189,516,7.5,19.6
627,1400000US24031700310,221,4.6,115,106,5.0,4.3
628,1400000US24031700311,69,1.3,9,60,0.3,2.3
629,1400000US24031700312,135,2.9,85,50,3.6,2.2
630,1400000US24031700400,104,4.7,59,45,5.0,4.3
631,1400000US24031700500,121,1.9,77,44,2.5,1.4
632,1400000US24031700604,158,2.4,83,75,2.5,2.3
633,1400000US24031700606,24,0.5,24,0,1.1,0.0
634,1400000US24031700608,230,3.8,140,90,4.7,3.0
635,1400000US24031700610,27,1.4,14,13,1.5,1.3
636,1400000US24031700613,171,2.7,92,79,2.8,2.6
637,1400000US24031700614,147,3.1,54,93,2.3,3.9
638,1400000US24031700615,28,0.9,16,12,1.0,0.8
639,1400000US24031700616,11,0.3,0,11,0.0,0.5
640,1400000US24031700704,138,4.8,0,138,0.0,9.5
641,1400000US24031700706,341,10.5,187,154,12.6,8.7
642,1400000US24031700711,262,4.6,117,145,4.5,4.8
643,1400000US24031700713,522,9.7,218,304,8.0,11.6
644,1400000US24031700715,322,5.4,85,237,2.9,7.9
645,1400000US24031700716,728,9.2,371,357,9.4,9.0
646,1400000US24031700717,822,14.0,442,380,14.5,13.4
647,1400000US24031700719,1086,16.5,452,634,13.4,19.7
648,1400000US24031700720,333,10.1,194,139,11.9,8.4
649,1400000US24031700721,221,9.6,59,162,5.7,12.6
650,1400000US24031700722,150,3.2,81,69,3.4,3.1
651,1400000US24031700724,678,23.9,252,426,17.8,30.0
652,1400000US24031700810,181,3.6,61,120,2.5,4.5
653,1400000US24031700811,322,7.2,146,176,7.4,7.0
654,1400000US24031700812,62,1.4,25,37,1.2,1.7
655,1400000US24031700101,89,2.2,57,32,2.7,1.6
656,1400000US24031700103,80,1.4,19,61,0.7,2.1
657,1400000US24031700104,286,6.0,85,201,3.8,7.9
658,1400000US24031700204,12,0.6,2,10,0.2,1.0
659,1400000US24031700205,149,2.6,45,104,1.6,3.5
660,1400000US24031700206,34,0.6,34,0,1.2,0.0
661,1400000US24031700207,701,12.5,307,394,11.3,13.6
662,1400000US24031700208,22,1.1,15,7,1.6,0.7
663,1400000US24031700306,301,4.3,188,113,5.7,3.1
664,1400000US24031700813,552,9.7,324,228,11.1,8.1
665,1400000US24031700816,315,3.9,145,170,3.7,4.1
666,1400000US24031700817,354,7.3,163,191,8.0,6.9
667,1400000US24031700818,733,12.0,378,355,11.7,12.3
668,1400000US24031700819,174,2.7,146,28,4.6,0.9
669,1400000US24031700822,121,7.5,20,101,3.3,9.9
670,1400000US24031700823,168,5.4,69,99,4.5,6.2
671,1400000US24033803300,425,10.2,138,287,7.3,12.6
672,1400000US24033803401,189,13.5,73,116,11.2,15.4
673,1400000US24033803402,789,16.6,292,497,14.5,18.2
674,1400000US24033803508,1488,31.8,740,748,36.8,28.1
675,1400000US24033803509,246,9.5,114,132,9.3,9.7
676,1400000US24033803513,179,3.8,48,131,2.3,5.0
677,1400000US24033803514,270,6.6,11,259,0.7,10.4
678,1400000US24033803516,76,1.6,0,76,0.0,2.9
679,1400000US24033806711,333,9.1,120,213,7.1,10.8
680,1400000US24033806713,731,20.7,308,423,20.5,20.8
681,1400000US24033806714,147,4.8,15,132,0.9,9.7
682,1400000US24033806800,167,4.3,82,85,4.1,4.5
683,1400000US24033806900,293,6.9,110,183,5.6,8.0
684,1400000US24033807000,1457,27.9,934,523,32.9,22.0
685,1400000US24033807102,257,9.6,232,25,15.3,2.2
686,1400000US24033807200,2471,67.1,1491,980,70.0,63.2
687,1400000US24033807301,812,23.9,480,332,27.4,20.1
688,1400000US24033807305,189,5.4,60,129,3.3,7.6
689,1400000US24033807404,122,2.7,59,63,2.5,3.0
690,1400000US24033807407,112,1.9,0,112,0.0,3.7
691,1400000US24033807408,108,2.0,38,70,1.5,2.6
692,1400000US24033807409,468,13.8,227,241,12.5,15.3
693,1400000US24033807410,252,7.1,129,123,7.1,7.0
694,1400000US24033803520,22,0.5,0,22,0.0,0.9
695,1400000US24033803521,145,3.2,33,112,2.0,3.9
696,1400000US24033803522,100,2.6,26,74,1.6,3.4
697,1400000US24033803523,150,3.9,41,109,2.5,5.0
698,1400000US24033803524,25,0.8,25,0,1.7,0.0
699,1400000US24033803526,120,3.7,43,77,2.7,4.7
700,1400000US24033803527,70,2.2,14,56,1.0,3.2
701,1400000US24033803601,152,4.3,90,62,5.6,3.2
702,1400000US24033803602,242,14.0,89,153,13.1,14.6
703,1400000US24033803605,720,10.5,347,373,10.6,10.4
704,1400000US24033803606,156,3.0,39,117,1.5,4.5
705,1400000US24033803608,323,6.3,30,293,1.3,10.7
706,1400000US24033803610,247,8.2,93,154,6.2,10.0
707,1400000US24033803612,437,14.9,212,225,16.7,13.4
708,1400000US24033803700,193,8.2,56,137,4.7,11.8
709,1400000US24033803801,291,13.8,124,167,11.8,15.9
710,1400000US24033803803,526,9.2,173,353,5.7,13.2
711,1400000US24033803900,327,7.9,166,161,7.4,8.6
712,1400000US24033804002,498,12.3,180,318,8.5,16.3
713,1400000US24033804101,140,4.7,47,93,3.0,6.6
714,1400000US24033804102,987,14.8,278,709,9.6,18.8
715,1400000US24033804200,286,9.5,130,156,8.9,10.1
716,1400000US24033804300,681,18.1,347,334,19.6,16.8
717,1400000US24033804600,412,14.0,217,195,15.2,12.8
718,1400000US24033804700,490,13.5,213,277,11.1,16.2
719,1400000US24033804801,378,16.0,187,191,15.5,16.5
720,1400000US24033804802,589,21.6,164,425,11.9,31.4
721,1400000US24033805000,724,14.2,170,554,8.6,17.8
722,1400000US24033805101,242,6.5,140,102,6.8,6.1
723,1400000US24033805201,933,22.9,494,439,25.3,20.7
724,1400000US24033805202,510,13.0,245,265,11.5,14.8
725,1400000US24033805500,332,10.2,147,185,8.6,12.0
726,1400000US24033805602,1023,21.3,624,399,18.7,27.2
727,1400000US24033805700,731,13.7,431,300,14.5,12.7
728,1400000US24033805801,854,17.6,327,527,13.1,22.5
729,1400000US24033805802,505,13.6,265,240,12.9,14.5
730,1400000US24033805906,476,16.1,203,273,12.9,19.8
731,1400000US24033805907,561,14.7,299,262,16.5,13.0
732,1400000US24033805908,388,16.7,163,225,13.3,20.4
733,1400000US24033805909,840,19.8,514,326,22.7,16.5
734,1400000US24033806000,754,16.2,396,358,16.9,15.6
735,1400000US24033806100,157,3.7,54,103,2.4,5.1
736,1400000US24033806300,117,5.9,71,46,7.1,4.7
737,1400000US24033806400,151,4.6,67,84,4.0,5.2
738,1400000US24033806501,603,11.6,275,328,9.5,14.3
739,1400000US24033806601,659,15.7,259,400,11.5,20.6
740,1400000US24033806706,566,16.1,96,470,6.0,24.5
741,1400000US24033806708,660,13.6,200,460,9.5,16.7
742,1400000US24033806710,90,1.4,54,36,2.0,1.0
743,1400000US24033803607,67,2.0,16,51,1.0,3.1
744,1400000US24031701417,591,10.6,264,327,10.4,10.8
745,1400000US24033801908,82,2.2,45,37,2.6,1.8
746,1400000US24033807405,230,4.6,187,43,7.7,1.7
747,1400000US24031704502,72,2.7,27,45,2.3,3.1
748,1400000US24031700832,137,5.1,64,73,4.6,5.7
749,1400000US24031700833,360,8.4,153,207,7.6,9.0
750,1400000US24031700834,550,10.9,347,203,13.2,8.4
751,1400000US24031700835,34,0.7,34,0,1.5,0.0
752,1400000US24031700902,92,2.8,34,58,2.1,3.6
753,1400000US24031700903,204,12.7,71,133,10.4,14.4
754,1400000US24031700904,152,5.8,67,85,5.2,6.4
755,1400000US24031700905,92,2.3,24,68,1.2,3.2
756,1400000US24031701001,305,5.9,136,169,5.6,6.1
757,1400000US24031701004,333,6.5,159,174,6.4,6.7
758,1400000US24031701005,8,0.3,8,0,0.6,0.0
759,1400000US24031701006,134,2.5,46,88,1.8,3.0
760,1400000US24031701007,75,2.4,36,39,2.8,2.1
761,1400000US24031701101,253,5.9,119,134,6.1,5.8
762,1400000US24031701201,184,3.5,51,133,2.0,4.9
763,1400000US24031701202,122,4.7,48,74,3.8,5.5
764,1400000US24031701205,220,3.5,108,112,3.6,3.4
765,1400000US24031701206,132,2.1,78,54,2.5,1.7
766,1400000US24031701211,148,2.6,43,105,1.7,3.5
767,1400000US24031701212,56,2.0,37,19,2.7,1.4
768,1400000US24031701213,195,3.9,63,132,2.8,4.7
769,1400000US24031701214,64,2.6,23,41,2.3,2.8
770,1400000US24031701216,133,4.0,74,59,4.7,3.3
771,1400000US24031701218,98,5.1,0,98,0.0,8.9
772,1400000US24031701219,332,10.8,50,282,3.3,18.1
773,1400000US24031701220,146,3.5,65,81,3.3,3.7
774,1400000US24031701221,301,6.6,62,239,2.9,9.9
775,1400000US24031701303,41,1.1,25,16,1.3,0.8
776,1400000US24031701306,23,0.7,23,0,1.6,0.0
777,1400000US24031701307,53,1.5,34,19,1.9,1.1
778,1400000US24031701308,134,4.4,48,86,2.9,6.2
779,1400000US24031701312,148,2.5,63,85,2.3,2.7
780,1400000US24031701314,70,2.5,16,54,1.2,3.6
781,1400000US24031701315,76,1.8,24,52,1.2,2.4
782,1400000US24031701316,139,2.5,41,98,1.6,3.2
783,1400000US24031701317,0,0.0,0,0,0.0,0.0
784,1400000US24031701408,345,5.3,212,133,6.4,4.2
785,1400000US24031701410,840,11.3,331,509,10.0,12.3
786,1400000US24031701414,781,10.6,268,513,8.2,12.5
787,1400000US24031701415,366,4.9,112,254,3.4,6.0
788,1400000US24031701418,0,0.0,0,0,0.0,0.0
789,1400000US24031701420,363,5.3,215,148,6.5,4.1
790,1400000US24031701421,343,20.2,135,208,19.5,20.7
791,1400000US24031701423,275,5.5,155,120,7.1,4.3
792,1400000US24031701503,57,0.8,11,46,0.3,1.4
793,1400000US24031701505,754,11.1,273,481,8.5,13.5
794,1400000US24031701506,111,2.3,63,48,2.8,1.9
795,1400000US24031701507,245,4.8,68,177,2.7,7.0
796,1400000US24031701509,880,15.8,436,444,16.7,15.0
797,1400000US24031701602,771,12.8,294,477,9.3,16.6
798,1400000US24031701701,156,5.0,92,64,5.9,4.0
799,1400000US24031701702,376,17.0,97,279,9.6,23.1
800,1400000US24031701703,158,4.1,44,114,2.6,5.4
801,1400000US24031701704,150,5.9,52,98,4.2,7.4
802,1400000US24031701800,538,12.5,278,260,12.8,12.1
803,1400000US24031702000,824,17.1,306,518,11.9,23.1
804,1400000US24031702101,621,10.6,337,284,11.1,10.0
805,1400000US24031701407,7,0.1,7,0,0.2,0.0
806,1400000US24031702200,138,3.4,16,122,0.8,5.8
807,1400000US24031702301,512,12.1,131,381,6.2,18.0
808,1400000US24031702302,319,7.6,72,247,3.7,11.2
809,1400000US24031702401,77,3.2,39,38,3.7,2.8
810,1400000US24031702402,531,13.2,186,345,9.4,17.0
811,1400000US24031702601,476,10.9,274,202,13.1,8.8
812,1400000US24031702602,877,20.0,403,474,20.3,19.7
813,1400000US24031702700,670,11.4,266,404,9.1,13.7
814,1400000US24031702800,333,7.4,79,254,3.5,11.4
815,1400000US24031702900,32,0.6,19,13,0.8,0.5
816,1400000US24031703000,78,4.3,36,42,4.0,4.5
817,1400000US24031703100,233,5.5,121,112,5.7,5.3
818,1400000US24031703202,411,7.1,223,188,7.8,6.5
819,1400000US24031703206,244,6.5,133,111,6.8,6.1
820,1400000US24031703207,735,14.7,288,447,11.6,17.7
821,1400000US24031703208,110,2.2,49,61,2.0,2.3
822,1400000US24031703210,139,4.1,67,72,4.0,4.2
823,1400000US24031703212,320,4.1,106,214,2.9,5.0
824,1400000US24031703213,1012,18.2,479,533,18.5,18.0
825,1400000US24031703214,895,13.8,325,570,10.0,17.6
826,1400000US24031703215,210,7.5,84,126,6.1,8.7
827,1400000US24031703216,275,8.0,91,184,6.5,9.0
828,1400000US24031703219,121,3.6,23,98,2.0,4.4
829,1400000US24031703220,613,13.6,228,385,11.9,14.8
830,1400000US24031703221,441,8.9,258,183,10.8,7.2
831,1400000US24031703302,327,7.7,120,207,5.9,9.5
832,1400000US24031703401,451,8.4,212,239,7.9,8.9
833,1400000US24031703403,608,18.1,397,211,22.1,13.5
834,1400000US24031703404,260,8.9,128,132,8.4,9.4
835,1400000US24031703501,1162,19.0,580,582,18.6,19.3
836,1400000US24031703502,590,18.7,182,408,12.2,24.5
837,1400000US24031703601,166,3.9,37,129,2.2,5.1
838,1400000US24031703701,209,5.9,119,90,6.4,5.4
839,1400000US24031703702,19,0.5,4,15,0.2,0.8
840,1400000US24031703800,387,12.3,218,169,14.8,10.1
841,1400000US24031703901,110,3.8,38,72,2.8,4.7
842,1400000US24031704000,389,6.5,150,239,5.5,7.3
843,1400000US24031704100,117,2.6,19,98,0.9,4.0
844,1400000US24031704200,152,8.2,68,84,7.3,9.1
845,1400000US24031704300,127,3.3,63,64,3.7,3.0
846,1400000US24031704401,237,7.6,183,54,11.8,3.4
847,1400000US24031704404,38,0.7,26,12,1.0,0.5
848,1400000US24031704501,122,3.9,17,105,1.2,6.4
849,1400000US24031704503,0,0.0,0,0,0.0,0.0
850,1400000US24031704600,97,1.9,73,24,2.9,0.9
851,1400000US24031704700,26,0.7,8,18,0.4,0.9
852,1400000US24031704803,77,2.4,24,53,1.9,2.7
853,1400000US24031704805,320,24.1,124,196,22.3,25.4
854,1400000US24031704806,169,6.0,84,85,5.6,6.4
855,1400000US24031705000,250,5.7,131,119,5.8,5.5
856,1400000US24031705100,92,1.8,33,59,1.4,2.1
857,1400000US24031705200,81,2.5,27,54,1.8,3.2
858,1400000US24031705400,33,1.2,21,12,1.6,0.8
859,1400000US24031705501,332,12.9,147,185,15.5,11.4
860,1400000US24031705502,109,2.7,45,64,2.2,3.2
861,1400000US24031705702,54,1.3,12,42,0.6,1.9
862,1400000US24031705800,86,1.5,37,49,1.3,1.6
863,1400000US24031705902,20,0.5,11,9,0.5,0.4
864,1400000US24031705903,171,3.9,83,88,3.9,3.9
865,1400000US24031706005,133,3.0,96,37,4.5,1.7
866,1400000US24031706007,143,2.1,51,92,1.6,2.5
867,1400000US24031706008,14,0.3,0,14,0.0,0.5
868,1400000US24031706009,94,1.7,18,76,0.7,2.8
869,1400000US24031706010,143,5.0,43,100,3.3,6.4
870,1400000US24031706012,305,8.7,90,215,6.4,10.3
871,1400000US24031706013,46,1.7,46,0,3.5,0.0
872,1400000US24033800102,128,4.3,90,38,6.3,2.4
873,1400000US24033800103,135,6.3,82,53,7.1,5.5
874,1400000US24033800105,124,3.6,71,53,4.4,2.9
875,1400000US24033800108,604,17.9,169,435,12.3,21.7
876,1400000US24033800109,222,5.1,0,222,0.0,9.3
877,1400000US24033800203,137,2.9,61,76,2.6,3.2
878,1400000US24033800206,198,4.6,48,150,2.3,6.8
879,1400000US24033800208,234,3.7,130,104,4.5,3.0
880,1400000US24033800210,464,15.7,235,229,14.4,17.2
881,1400000US24033800211,222,7.9,59,163,4.2,11.6
882,1400000US24033800212,123,4.7,39,84,3.9,5.2
883,1400000US24033800213,315,8.0,213,102,11.7,4.8
884,1400000US24033800215,71,2.6,48,23,4.2,1.5
885,1400000US24033800401,171,6.5,9,162,0.7,11.9
886,1400000US24033800402,8,0.2,0,8,0.0,0.3
887,1400000US24033800403,65,1.6,52,13,2.7,0.6
888,1400000US24033800409,108,1.7,43,65,1.3,2.0
889,1400000US24033800410,121,2.2,71,50,2.7,1.7
890,1400000US24033800411,218,5.2,68,150,3.1,7.3
891,1400000US24033800412,236,7.1,124,112,8.3,6.1
892,1400000US24033800504,256,5.3,97,159,4.3,6.2
893,1400000US24033800505,219,8.6,105,114,8.3,8.8
894,1400000US24033800507,61,2.3,23,38,1.7,2.9
895,1400000US24033800509,259,3.1,142,117,4.0,2.5
896,1400000US24033800511,124,2.5,115,9,5.0,0.3
897,1400000US24033800513,172,3.2,72,100,2.6,3.9
898,1400000US24033800515,274,7.4,165,109,10.4,5.1
899,1400000US24033800516,199,6.2,112,87,6.8,5.5
900,1400000US24033800517,60,1.2,60,0,2.6,0.0
901,1400000US24033800518,35,1.2,0,35,0.0,2.3
902,1400000US24033800520,43,2.1,43,0,5.0,0.0
903,1400000US24033800601,99,5.1,34,65,3.4,7.0
904,1400000US24033800604,96,5.6,0,96,0.0,9.8
905,1400000US24033800605,155,3.8,87,68,4.9,2.9
906,1400000US24033800606,177,4.0,50,127,2.4,5.3
907,1400000US24033800607,96,1.7,0,96,0.0,3.0
908,1400000US24033800608,61,2.0,39,22,2.7,1.3
909,1400000US24033800701,17,0.4,17,0,0.8,0.0
910,1400000US24033800705,42,1.0,0,42,0.0,2.1
911,1400000US24033800706,30,0.8,30,0,1.7,0.0
912,1400000US24033800707,236,8.8,138,98,11.4,6.6
913,1400000US24033800800,107,3.1,64,43,3.4,2.7
914,1400000US24033800900,68,4.3,26,42,3.3,5.4
915,1400000US24033801003,117,3.4,73,44,4.3,2.4
916,1400000US24033801004,50,1.4,0,50,0.0,2.7
917,1400000US24033801104,0,0.0,0,0,0.0,0.0
918,1400000US24033801207,97,2.4,22,75,1.2,3.4
919,1400000US24033801208,0,0.0,0,0,0.0,0.0
920,1400000US24033801210,51,1.1,0,51,0.0,1.9
921,1400000US24033801211,131,4.3,23,108,1.6,6.7
922,1400000US24033801212,97,2.9,50,47,3.0,2.7
923,1400000US24033801213,207,5.9,97,110,6.0,5.8
924,1400000US24033801214,196,5.1,25,171,1.4,8.2
925,1400000US24033801215,32,1.3,8,24,0.7,1.8
926,1400000US24033801217,80,2.6,16,64,1.1,3.9
927,1400000US24033801302,45,1.6,22,23,1.4,1.8
928,1400000US24033801305,49,0.8,7,42,0.3,1.3
929,1400000US24033801307,53,1.5,10,43,0.6,2.2
930,1400000US24033801309,80,2.5,46,34,2.9,2.1
931,1400000US24033801310,33,0.5,33,0,1.0,0.0
932,1400000US24033801311,309,5.7,204,105,8.1,3.6
933,1400000US24033801312,527,14.5,206,321,11.1,18.0
934,1400000US24033801404,281,6.0,101,180,4.2,8.0
935,1400000US24033801405,299,6.1,88,211,4.0,7.7
936,1400000US24033801406,764,24.3,152,612,12.1,32.3
937,1400000US24033801407,304,5.1,17,287,0.6,9.0
938,1400000US24033801408,122,3.7,94,28,7.7,1.3
939,1400000US24033801410,66,1.7,17,49,0.9,2.7
940,1400000US24033801411,80,2.3,30,50,1.8,2.7
941,1400000US24033801500,90,4.1,28,62,2.7,5.4
942,1400000US24033801600,263,9.8,79,184,5.9,13.7
943,1400000US24033801701,374,9.9,173,201,10.0,9.8
944,1400000US24033801704,653,11.5,373,280,13.9,9.4
945,1400000US24033801706,166,10.2,70,96,10.1,10.2
946,1400000US24033801707,803,12.9,281,522,10.3,15.0
947,1400000US24033801708,147,4.2,69,78,4.3,4.1
948,1400000US24033801802,182,4.8,60,122,3.3,6.1
949,1400000US24033801804,281,14.2,172,109,16.7,11.5
950,1400000US24033801807,520,10.9,198,322,8.7,12.8
951,1400000US24033801808,263,7.3,99,164,5.5,9.1
952,1400000US24033801901,247,5.2,120,127,5.2,5.3
953,1400000US24033801904,217,6.3,45,172,2.5,10.3
954,1400000US24033801905,157,3.3,130,27,5.8,1.1
955,1400000US24033801906,213,9.6,97,116,8.5,10.9
956,1400000US24033801907,355,9.7,144,211,8.5,10.7
957,1400000US24033802001,186,3.3,114,72,4.5,2.4
958,1400000US24033802002,114,3.3,43,71,2.8,3.6
959,1400000US24033802103,26,1.0,19,7,1.6,0.5
960,1400000US24033802106,545,12.5,327,218,16.0,9.5
961,1400000US24033802107,365,8.4,217,148,10.6,6.5
962,1400000US24033802201,142,8.2,22,120,3.0,11.9
963,1400000US24033802204,221,3.9,106,115,4.5,3.4
964,1400000US24033802301,152,3.8,78,74,4.2,3.5
965,1400000US24033802404,850,18.8,338,512,19.3,18.5
966,1400000US24033802405,290,8.1,144,146,8.9,7.4
967,1400000US24033802407,654,15.1,313,341,16.9,13.8
968,1400000US24033802408,364,22.0,167,197,19.5,24.6
969,1400000US24033802501,253,7.5,105,148,6.2,8.8
970,1400000US24033802502,214,7.9,184,30,12.3,2.5
971,1400000US24033802700,169,7.0,61,108,5.5,8.3
972,1400000US24033802803,624,12.5,358,266,16.2,9.5
973,1400000US24033802804,331,6.0,155,176,6.2,5.7
974,1400000US24033802805,824,17.1,345,479,15.5,18.4
975,1400000US24033802901,786,19.4,409,377,20.9,18.1
